This is the introduction text. Type "help" to see the game rules and instructions.

Gates
An Interactive Fiction by S R Williams
Release 1 / Serial number 191010 / Inform 7 build 6M62 (I6/v6.33 lib 6/12N) SD

Archives
A marble monument to knowledge. DingCorp Bank is to the north, the Hospital to the west, Silver Rush to the south and the Job Centre to the east.

You can see a research device here.

>x phone
You see nothing special about the phone.

* * *

This is the introduction text. Type "help" to see the game rules and instructions.

Gates
An Interactive Fiction by S R Williams
Release 1 / Serial number 191010 / Inform 7 build 6M62 (I6/v6.33 lib 6/12N) SD

Archives
A marble monument to knowledge. DingCorp Bank is to the north, the Hospital to the west, Silver Rush to the south and the Job Centre to the east.

You can see a research device here.

>x notepad
Your investigative notead. Scrawled at the top in pencil is "Visit Virgil".

* * *

This is the introduction text. Type "help" to see the game rules and instructions.

Gates
An Interactive Fiction by S R Williams
Release 1 / Serial number 191010 / Inform 7 build 6M62 (I6/v6.33 lib 6/12N) SD

Archives
A marble monument to knowledge. DingCorp Bank is to the north, the Hospital to the west, Silver Rush to the south and the Job Centre to the east.

You can see a research device here.

>use phone
You can't see any such thing.

>use desk
You use the something for its intended purpose.

* * *

This is the introduction text. Type "help" to see the game rules and instructions.

Gates
An Interactive Fiction by S R Williams
Release 1 / Serial number 191010 / Inform 7 build 6M62 (I6/v6.33 lib 6/12N) SD

Archives
A marble monument to knowledge. DingCorp Bank is to the north, the Hospital to the west, Silver Rush to the south and the Job Centre to the east.

You can see a research device here.

>use desk
You sit at your desk and begin to work.

>use notead
You can't see any such thing.

>use notepad
You don't know what to do with the notepad.

>x notepad
Scrawled at the top in pencil is "Visit Virgil".

* * *

This is the introduction text. Type "help" to see the game rules and instructions.

Gates
An Interactive Fiction by S R Williams
Release 1 / Serial number 191010 / Inform 7 build 6M62 (I6/v6.33 lib 6/12N) SD

Archives
A marble monument to knowledge. DingCorp Bank is to the north, the Hospital to the west, Silver Rush to the south and the Job Centre to the east.

You can see a research device here.

>use notepad
You don't know what to do with the notepad.

>use desk
You sit at your desk and begin to work.

>use bed
You lie down to rest for a while.

>sleep in bed
I only understood you as far as wanting to sleep.

>sleep
You aren't feeling especially drowsy.

>wait
Time passes.

>use bed
You lie down to rest for a while.

>x notepad
Scrawled at the top in pencil is "Visit Virgil".

* * *

This is the introduction text. Type "help" to see the game rules and instructions.

Gates
An Interactive Fiction by S R Williams
Release 1 / Serial number 191010 / Inform 7 build 6M62 (I6/v6.33 lib 6/12N) SD

Archives
A marble monument to knowledge. DingCorp Bank is to the north, the Hospital to the west, Silver Rush to the south and the Job Centre to the east.

You can see a research device here.

>south
Frobisher Street

>east
Hanger Bridge
Apparently this rickety old bridge is named for the gibbet that used to adorn its top. Those days are thankfully long gone.

>exits
That's not a verb I recognise.

>exit
But you aren't in anything at the moment.

>go to Silver Rush
You travel to the Silver Rush Boutique
Silver Rush Boutique
The inside of this place looks unassuming, but its vast warehouses out back almost always contain something worth having - if you have the money. The heavies lounging behind the counter look relaxed, but you know they're ready for even the slightest whiff of trouble.

On the counter is the Silver Rush Catalogue.

* * *

This is the introduction text. Type "help" to see the game rules and instructions.

Gates
An Interactive Fiction by S R Williams
Release 1 / Serial number 191010 / Inform 7 build 6M62 (I6/v6.33 lib 6/12N) SD

Archives
A marble monument to knowledge. DingCorp Bank is to the north, the Hospital to the west, Silver Rush to the south and the Job Centre to the east.

You can see a research device here.

>go to Frobisher Street
You travel to Frobisher Street.

Frobisher Street

>l
Frobisher Street

>e
Hanger Bridge
Apparently this rickety old bridge is named for the gibbet that used to adorn its top. Those days are thankfully long gone.

>e
Outside Virgil's House
You are outside Virgil's house, a reasonable modern brick construction.

You can see Virgil and an Incursion Scanner here.

>n
Outside Virgil's House
You are outside Virgil's house, a reasonable modern brick construction.

You can see Virgil and an Incursion Scanner here.

* * *

This is the introduction text. Type "help" to see the game rules and instructions.

Gates
An Interactive Fiction by S R Williams
Release 1 / Serial number 191010 / Inform 7 build 6M62 (I6/v6.33 lib 6/12N) SD

Archives
A marble monument to knowledge. DingCorp Bank is to the north, the Hospital to the west, Silver Rush to the south and the Job Centre to the east.

You can see a research device here.

>go to Virgil
That noun did not make sense in this context.

>go to Virgil's House
You travel to Outside Virgil's House.

Outside Virgil's House
You are outside Virgil's house, a reasonable modern brick construction.

You can see Virgil and an Incursion Scanner here.

>n
Outside Virgil's House
You are outside Virgil's house, a reasonable modern brick construction.

You can see Virgil and an Incursion Scanner here.

>n
Outside Virgil's House
You are outside Virgil's house, a reasonable modern brick construction.

You can see Virgil and an Incursion Scanner here.

>s
Outside Virgil's House
You are outside Virgil's house, a reasonable modern brick construction.

You can see Virgil and an Incursion Scanner here.

* * *

This is the introduction text. Type "help" to see the game rules and instructions.

Gates
An Interactive Fiction by S R Williams
Release 1 / Serial number 191010 / Inform 7 build 6M62 (I6/v6.33 lib 6/12N) SD

Archives
A marble monument to knowledge. DingCorp Bank is to the north, the Hospital to the west, Silver Rush to the south and the Job Centre to the east.

You can see a research device here.

>go to Virgil's house
You travel to Virgil's House.

Virgil's House
You can see Virgil and an Incursion Scanner here.

>ask virgil about scanner
You can only do that to something animate.

* * *

This is the introduction text. Type "help" to see the game rules and instructions.

Gates
An Interactive Fiction by S R Williams
Release 1 / Serial number 191010 / Inform 7 build 6M62 (I6/v6.33 lib 6/12N) SD

Archives
A marble monument to knowledge. DingCorp Bank is to the north, the Hospital to the west, Silver Rush to the south and the Job Centre to the east.

You can see a research device here.

>go to Virgil's House
You travel to Virgil's House.

Virgil's House
You can see Virgil and an Incursion Scanner here.

>ask Virgil about stones
There is no reply.

>get scanner
Taken.

>i
You are carrying:
  an Incursion Scanner

>x scanner
You see nothing special about the Incursion Scanner.

>use scanner
You check the Incursion Scanner. All clear.

>s
Gloom Lane
You are in Gloom Lane. Virgil's house lies to the north, a reasonable modern brick construction.

>e
You can't go that way.

>w
Hanger Bridge
Apparently this rickety old bridge is named for the gibbet that used to adorn its top. Those days are thankfully long gone.

* * *

This is the introduction text. Type "help" to see the game rules and instructions.

Gates
An Interactive Fiction by S R Williams
Release 1 / Serial number 191010 / Inform 7 build 6M62 (I6/v6.33 lib 6/12N) SD

Archives
A marble monument to knowledge. DingCorp Bank is to the north, the Hospital to the west, Silver Rush to the south and the Job Centre to the east.

You can see a research device here.

>get desk
That's fixed in place.

>get town map
Taken.

>get notepad
Taken.

>x map
A map of the town, showing all the key locations and some others you've pencilled in for yourself.

>use map
You don't know what to do with the town map.

* * *

This is the introduction text. Type "help" to see the game rules and instructions.

Gates
An Interactive Fiction by S R Williams
Release 1 / Serial number 191010 / Inform 7 build 6M62 (I6/v6.33 lib 6/12N) SD

Archives
A marble monument to knowledge. DingCorp Bank is to the north, the Hospital to the west, Silver Rush to the south and the Job Centre to the east.

You can see a research device here.

>n
DingCorp Bank
An imposing corporate edifice. The Northern district sprawls to the north of here, while the Archives lie to the south.

>n
Northern District
A vast maze of blocks stretching for miles, the Northern District is clean and green and houses the more affluent elements of the city. To the south is the impressive facde of DingCorp Bank.

You can see a cab (in which is a driver) here.

>n
You can't go that way.

>e
You can't go that way.

>s
DingCorp Bank

>w
You can't go that way.

>e
You can't go that way.

>n
Northern District

>n
You can't go that way.

>l
Northern District

* * *

>n
Northern District
A vast maze of blocks stretching for miles, the Northern District is clean and green and houses the more affluent elements of the city. To the south is the impressive facde of DingCorp Bank.

You can see a cab (in which is a driver) here.

>enter cab
You climb into the cab. The driver says, "Where to?"

>NE-12
That's not a verb I recognise.

>go to mine
"Sure!" The cab drives off. After a time it arrives at the mine on the outskirts of the city. You pay the driver and get out.

Crystal Mine
You can see a cab (in which is a driver) here.

>mine
You explore the caves in search of crystals.

*** Run-time problem P31: Attempt to use a property of the 'nothing' non-object: property crystals

You wander the caverns, but find nothing of interest.

* * *

>n
Northern District
A vast maze of blocks stretching for miles, the Northern District is clean and green and houses the more affluent elements of the city. To the south is the impressive facde of DingCorp Bank.

You can see a cab (in which is a driver) here.

>enter can
You can't see any such thing.

>enter cab
You climb into the cab. The driver says, "Where to?"

>go to mine
"Sure!" The cab drives off. After a time it arrives at the mine on the outskirts of the city. You pay the driver and get out.

Crystal Mine
A rent in the earth disapears into a darkness ahead of you, leading into an underground labyrinth. Precious crystals are here for the taking.

You can see a cab (in which is a driver) here.

>explore
You enter the opening and descend into the darkness. Outside of the tiny illuminated sphere of your flickering yellow lamp light, it is pitck dark.
After some time, you detect the strange ethereal glow of your quarry ahead! You dig out the cache, taking 2 crystals.

>explore
You enter the opening and descend into the darkness. Outside of the tiny illuminated sphere of your flickering yellow lamp light, it is pitck dark.
After some time, you detect the strange ethereal glow of your quarry ahead! You dig out the cache, taking 4 crystals.

>l
Crystal Mine
A rent in the earth disapears into a darkness ahead of you, leading into an underground labyrinth. Precious crystals are here for the taking.

You can see a cab (in which is a driver) here.

>enter cab
You climb into the cab. The driver says, "Where to?"

>go to city
"Sure!" The cab returns to the centre of town. You pay the driver and get out.

Northern District
A vast maze of blocks stretching for miles, the Northern District is clean and green and houses the more affluent elements of the city. To the south is the impressive facde of DingCorp Bank.

You can see a cab (in which is a driver) here.

* * *

>s,s,e,n
DingCorp Bank
An imposing corporate edifice. The Northern district sprawls to the north of here, while the Archives lie to the south.

Archives
A marble monument to knowledge. DingCorp Bank is to the north, the Hospital to the west, Silver Rush to the south and the Job Centre to the east.

You can see a research device here.

Job Centre
A squat block, this place is the place where protifable business actions are transacted - for a fee, of course. The the west lies the Archives, to the north the Prospector's Guild, to the south the Training complex, and to the east a minor bank.

Prospector's Guild
A somewhat ramshackle affair that belies the incredible wealth that the guild controls. In some sense, all of the city revolves around this place. To the south is the Job Cenre, while to the east is a minor bank.

On the wall a battered sign exclaims "Exchange crystals for ready cash! Great rates available!"

You can also see a teller here.

>sell crystals
You show your haul to the teller. After some haggling, she agrees to take the crystals off your hands for $12. You shake hands on the deal and take the cash; she wraps the crystals in crystallite and stashes them in a safe behind the counter.

>l
Prospector's Guild
A somewhat ramshackle affair that belies the incredible wealth that the guild controls. In some sense, all of the city revolves around this place. To the south is the Job Cenre, while to the east is a minor bank.

On the wall a battered sign exclaims "Exchange crystals for ready cash! Great rates available!"

You can also see a teller here.

>sell crystals
You don't have any crystals to sell.

>s
Job Centre
A squat block, this place is the place where protifable business actions are transacted - for a fee, of course. The the west lies the Archives, to the north the Prospector's Guild, to the south the Training complex, and to the east a minor bank.

>l
Job Centre
A squat block, this place is the place where protifable business actions are transacted - for a fee, of course. The the west lies the Archives, to the north the Prospector's Guild, to the south the Training complex, and to the east a minor bank.

>n
Prospector's Guild
A somewhat ramshackle affair that belies the incredible wealth that the guild controls. In some sense, all of the city revolves around this place. To the south is the Job Cenre, while to the east is a minor bank.

On the wall a battered sign exclaims "Exchange crystals for ready cash! Great rates available!"

You can also see a teller here.

>x mapp
You can't see any such thing.

>x map
The incursion scanner lets out a warning clang. The display updates. Its timer now shows 06:00 and its display reads BlingCorp Bank.

>s,e,n
Job Centre
A squat block, this place is the place where protifable business actions are transacted - for a fee, of course. The the west lies the Archives, to the north the Prospector's Guild, to the south the Training complex, and to the east a minor bank.

Minor Bank 2
An unassuming brick co-operative. To the west is the Job Centre.

BlingCorp Bank
This baroque structure is bedecked with gold leaf and statues of various important persons in attitudes of important business, straddling the line between gaudy and magnificent. To the south is a much humbler minor bank, while to the east the Eastern District sprawls over the hills.

>z
Time passes.

>z
Time passes.

>z
Time passes.

Your incursion scanner lets out a ringing chime. Its timer is 0, and its display reads BlingCorp Bank. A red light comes on.

With a strange wrenching motion, things appear to unfold from thin air! They drop to the ground, gargling, and rush towards the vault.

>l
BlingCorp Bank
This baroque structure is bedecked with gold leaf and statues of various important persons in attitudes of important business, straddling the line between gaudy and magnificent. To the south is a much humbler minor bank, while to the east the Eastern District sprawls over the hills.

You can see a Gark here.

>fight Gark
You fight the group of 4 Garks!
You hit!

The group of 4 Garks attacks!
You are wounded!

>fight Gark
You fight the group of 4 Garks!
You fail to harm the group of 4 Garks.

The group of 4 Garks attacks!
You are wounded!

>fight Gark
You fight the group of 4 Garks!
You hit!
One of the group of 4 Garks falls, leaving 3!

The group of 3 Garks attacks!
You shrug off the blow.

>fight Gark
You fight the group of 3 Garks!
You hit!

The group of 3 Garks attacks!
You shrug off the blow.

>fight Gark
You fight the group of 3 Garks!
You hit!
One of the group of 3 Garks falls, leaving 2!

The group of 2 Garks attacks!
You shrug off the blow.

>fight Gark
You fight the group of 2 Garks!
You hit!

The group of 2 Garks attacks!
You shrug off the blow.

>fight Gark
You fight the group of 2 Garks!
You hit!
One of the group of 2 Garks falls, leaving 1!

The Gark attacks!
You shrug off the blow.

Clucking wildly, the monsters retreat in disarray. With an eye-wrenching twist in space, they fold up into nothing and vanish.
The red light on your scanner blinks out suddenly.

>l
BlingCorp Bank
This baroque structure is bedecked with gold leaf and statues of various important persons in attitudes of important business, straddling the line between gaudy and magnificent. To the south is a much humbler minor bank, while to the east the Eastern District sprawls over the hills.

>s
Minor Bank 2
An unassuming brick co-operative. To the west is the Job Centre.

>w
Job Centre
A squat block, this place is the place where protifable business actions are transacted - for a fee, of course. The the west lies the Archives, to the north the Prospector's Guild, to the south the Training complex, and to the east a minor bank.

>l
Job Centre
A squat block, this place is the place where protifable business actions are transacted - for a fee, of course. The the west lies the Archives, to the north the Prospector's Guild, to the south the Training complex, and to the east a minor bank.

* * *

>w
Archives
A marble monument to knowledge. DingCorp Bank is to the north, the Hospital to the west, Silver Rush to the south and the Job Centre to the east.

You can see a research device here.

The incursion scanner lets out a warning clang. The display updates. Its timer now shows 06:00 and its display reads Minor Bank 4.

>research
That's not a verb I recognise.

>use research
You sit down and begin to check the records. Time passes as you fall into your task, the clacking of the typeboard and the whoosh of arriving papers sinking into your subconcious.

You sit back for a break. Nothing so far.

>research
That's not a verb I recognise.

* * *

>use research
You sit down and begin to check the records. Time passes as you fall into your task, the clacking of the typeboard and the whoosh of arriving papers sinking into your subconcious.

You sit back for a break. Nothing so far.

>use research
You sit down and begin to check the records. Time passes as you fall into your task, the clacking of the typeboard and the whoosh of arriving papers sinking into your subconcious.

You sit back for a break. Nothing so far.

>z
Time passes.

>z
Time passes.

Your incursion scanner lets out a ringing chime. Its timer is 0, and its display reads Minor Bank 4. A red light comes on.

The red light on your scanner blinks out suddenly.

>l
Archives
A marble monument to knowledge. DingCorp Bank is to the north, the Hospital to the west, Silver Rush to the south and the Job Centre to the east.

You can see a research device here.

>n,n
DingCorp Bank
An imposing corporate edifice. The Northern district sprawls to the north of here, while the Archives lie to the south.

Northern District
A vast maze of blocks stretching for miles, the Northern District is clean and green and houses the more affluent elements of the city. To the south is the impressive facde of DingCorp Bank.

You can see a cab (in which is a driver) here.

>enter cab
You climb into the cab. The driver says, "Where to?"

>go to ND-12
"Sure!" The cab moves off. After a time, the cab pulls up at your destination. You pay the driver and get out.

Urban Sprawl
You are deep within the maze of urban life,. A sign nearby reads ND-12.

You can see a cab (in which is a driver) here.

>search
You thoroughly search the area. You have found Bob Jones!

>x Bob
You see nothing special about Bob Jones.

>interrogate Bob
That's not a verb I recognise.

>interrogate
That's not a verb I recognise.

>talk to Bob
You fail to persuade Bob. They walk away, looking agitated.

>search
You thoroughly search the area. You have found Bob Jones!

>talk to Bob
You fail to persuade Bob. They walk away, looking agitated.

* * *

>search
You thoroughly search the area. You have found Bob Jones!

>talk to Bob
You fail to persuade Bob. They walk away, looking agitated.

The incursion scanner lets out a warning clang. The display updates. Its timer now shows 06:00 and its display reads PringCorp Bank.

>talk to Bob
You can't see any such thing.

>search
You thoroughly search the area. You have found Bob Jones!

* * *

>talk to Bob
You fail to persuade Bob. They walk away, looking agitated.

>talk
(to the driver)
You angrily berate the driver, but it doesn't make any difference.

>talk to bob
You can't see any such thing.

>talk to Bob
You can't see any such thing.

* * *

>search
You thoroughly search the area. You have found Bob Jones!

>talk to Bob
You persuade Bob!
"OK, I guess... I know the code fragment A1 is at position 10".

>l
Urban Sprawl
You are deep within the maze of urban life,. A sign nearby reads ND-12.

You can see Bob Jones and a cab (in which is a driver) here.

Your incursion scanner lets out a ringing chime. Its timer is 0, and its display reads PringCorp Bank. A red light comes on.

The red light on your scanner blinks out suddenly.

    *** The enemy has stolen all of the crystals! ***

Would you like to RESTART, RESTORE a saved game, QUIT or UNDO the last command?

* * *

>n
DingCorp Bank
An imposing corporate edifice. The Northern district sprawls to the north of here, while the Archives lie to the south.

>e
You can't go that way.

>w
You can't go that way.

>s
Archives
You are in the Archives, a marble monument to knowledge. DingCorp Bank is to the north, the Hospital to the west, Silver Rush to the south and the Job Centre to the east.

>west
Hosiptal
St. Clemens Hospital is a relatively modern construction. To the north lies PringCorp Bank, while a minor bank is to the south.

>north
You can't go that way.

I beg your pardon?

>n
You can't go that way.

>s
You can't go that way.

>e
Archives
You are in the Archives, a marble monument to knowledge. DingCorp Bank is to the north, the Hospital to the west, Silver Rush to the south and the Job Centre to the east.

* * *

>w
You can't go that way.

>n
Northern District
A vast maze of blocks stretching for miles, the Northern District is clean and green and houses the more affluent elements of the city. To the south is the impressive facde of DingCorp Bank.

>s
DingCorp Bank
An imposing corporate edifice. The Northern district sprawls to the north of here, while the Archives lie to the south.

>s
Archives
You are in the Archives, a marble monument to knowledge. DingCorp Bank is to the north, the Hospital to the west, Silver Rush to the south and the Job Centre to the east.

>w
Hospital
St. Clemens Hospital is a relatively modern construction. To the north lies PringCorp Bank, while a minor bank is to the south. The Archives lie east.

>n
PringCorp Bank
An austere brick block of a building. To the west sprawls the Western District, to the east the Hospital.

>w
Western District
Colourful and vibrant, the Western District is deprived in wealth but rich in culture. To the east lies the brick block of PringCorp bank.

>e
PringCorp Bank
An austere brick block of a building. To the west sprawls the Western District, to the east the Hospital.

>e
You can't go that way.

>n
You can't go that way.

>s
Hospital
St. Clemens Hospital is a relatively modern construction. To the north lies PringCorp Bank, while a minor bank is to the south. The Archives lie east.

>s
Minor Bank 1
A drab and beaurocratic affair, with a sign that reads "Clemens and Co.". To the north lies the Hospital.

>n
Hospital
St. Clemens Hospital is a relatively modern construction. To the north lies PringCorp Bank, while a minor bank is to the south. The Archives lie east.

>n
PringCorp Bank
An austere brick block of a building. To the west sprawls the Western District, to the east the Hospital.

>s
Hospital
St. Clemens Hospital is a relatively modern construction. To the north lies PringCorp Bank, while a minor bank is to the south. The Archives lie east.

>e
Archives
You are in the Archives, a marble monument to knowledge. DingCorp Bank is to the north, the Hospital to the west, Silver Rush to the south and the Job Centre to the east.

>n
DingCorp Bank
An imposing corporate edifice. The Northern district sprawls to the north of here, while the Archives lie to the south.

>n
Northern District
A vast maze of blocks stretching for miles, the Northern District is clean and green and houses the more affluent elements of the city. To the south is the impressive facde of DingCorp Bank.

* * *

>s
Archives
You are in the Archives, a marble monument to knowledge. DingCorp Bank is to the north, the Hospital to the west, Silver Rush to the south and the Job Centre to the east.

>s
Silver Rush
This unassuming place is not to be underestimated - it contains a huge collection of the latest gadgets and you can usually find a good deal. Burly guards lounge threateningly. To the north lies the sparkling marble of the Archives, to the south the spire of ZingCorp Bank.

>s
ZingCorp Bank
A twisting spire of some kind of black stone, this place is often referred to as the wizard's tower because of the affectations of the self-styled Grand Master Zing who runs it. To the north likes Silver Rush, to the south spreads the South District.

>s
Southern District
A modern district, this urban sprawl is largely home to the middle professional class - those of the crisp suit, the anonymous hat, and the briefcase full of dull papers. To the north is the blackened spire of ZingCorp bank.

>n
ZingCorp Bank
A twisting spire of some kind of black stone, this place is often referred to as the wizard's tower because of the affectations of the self-styled Grand Master Zing who runs it. To the north likes Silver Rush, to the south spreads the South District.

>n
Silver Rush
This unassuming place is not to be underestimated - it contains a huge collection of the latest gadgets and you can usually find a good deal. Burly guards lounge threateningly. To the north lies the sparkling marble of the Archives, to the south the spire of ZingCorp Bank.

>n
Archives
You are in the Archives, a marble monument to knowledge. DingCorp Bank is to the north, the Hospital to the west, Silver Rush to the south and the Job Centre to the east.

>w
Hospital
St. Clemens Hospital is a relatively modern construction. To the north lies PringCorp Bank, while a minor bank is to the south. The Archives lie east.

>e
Archives
You are in the Archives, a marble monument to knowledge. DingCorp Bank is to the north, the Hospital to the west, Silver Rush to the south and the Job Centre to the east.

>e
Job Centre
A squat block, this place is the place where protifable business actions are transacted - for a fee, of course. The the west likes the Archives, to the north the Prospector's Guild, to the south the Training complex, and to the east a minor bank.

>n
Prospector's Guild
A somewhat ramshackle affair that belies the incredible wealth that the guild controls. In some sense, all of the city revolves around this place. To the south is the Job Cenre, while to the east is a minor bank.

>e
Minor Bank 3
A neat whitewashed building, likely run by a successful dentist or similar. To the west lies the Prospector's Guild, while to the north glitters the BlingCorp Bank.

>n
BlingCorp Bank
This baroque structure is bedecked with gold leaf and statues of various important persons in attitudes of important business, straddling the line between gaudy and magnificent. To the south is a much humbler minor bank, while to the West the Western District sprawls over the hills.

>w
You can't go that way.

>e
Eastern District
Winding sinuously up into the hills that formerly were outside the town, the western district is largely middle class, and has absorbed several older villages. To the east is the grand BlingCorp Bank.

>w
BlingCorp Bank
This baroque structure is bedecked with gold leaf and statues of various important persons in attitudes of important business, straddling the line between gaudy and magnificent. To the south is a much humbler minor bank, while to the West the Western District sprawls over the hills.

>s
Minor Bank 3
A neat whitewashed building, likely run by a successful dentist or similar. To the west lies the Prospector's Guild, while to the north glitters the BlingCorp Bank.

>w
Prospector's Guild
A somewhat ramshackle affair that belies the incredible wealth that the guild controls. In some sense, all of the city revolves around this place. To the south is the Job Cenre, while to the east is a minor bank.

>s
Job Centre
A squat block, this place is the place where protifable business actions are transacted - for a fee, of course. The the west likes the Archives, to the north the Prospector's Guild, to the south the Training complex, and to the east a minor bank.

>e
Minor Bank 2
An unassuming brick co-operative. To the west is the Job Centre.

>w
Job Centre
A squat block, this place is the place where protifable business actions are transacted - for a fee, of course. The the west likes the Archives, to the north the Prospector's Guild, to the south the Training complex, and to the east a minor bank.

>n
Prospector's Guild
A somewhat ramshackle affair that belies the incredible wealth that the guild controls. In some sense, all of the city revolves around this place. To the south is the Job Cenre, while to the east is a minor bank.

>s
Job Centre
A squat block, this place is the place where protifable business actions are transacted - for a fee, of course. The the west likes the Archives, to the north the Prospector's Guild, to the south the Training complex, and to the east a minor bank.

>w
Archives
You are in the Archives, a marble monument to knowledge. DingCorp Bank is to the north, the Hospital to the west, Silver Rush to the south and the Job Centre to the east.

>go to Prospect
That noun did not make sense in this context.

>go to the Prospector's Guild
You travel to the Prospector's Guild.

Prospector's Guild
A somewhat ramshackle affair that belies the incredible wealth that the guild controls. In some sense, all of the city revolves around this place. To the south is the Job Cenre, while to the east is a minor bank.

>go to Zingcorp
You travel to ZingCorp Bank.

ZingCorp Bank
A twisting spire of some kind of black stone, this place is often referred to as the wizard's tower because of the affectations of the self-styled Grand Master Zing who runs it. To the north likes Silver Rush, to the south spreads the South District.

>go to Archives
You travel to the Archives.

Archives
You are in the Archives, a marble monument to knowledge. DingCorp Bank is to the north, the Hospital to the west, Silver Rush to the south and the Job Centre to the east.

>map
That's not a verb I recognise.

* * *

This is the introduction text. Type "help" to see the game rules and instructions.

Gates
An Interactive Fiction by S R Williams
Release 1 / Serial number 191010 / Inform 7 build 6M62 (I6/v6.33 lib 6/12N) SD

Archives
A marble monument to knowledge. DingCorp Bank is to the north, the Hospital to the west, Silver Rush to the south and the Job Centre to the east.

You can see a research device here.

>i
You are carrying:
  an incursion scanner
  a notebook
  a map

>use map
You look at the map.

>go to Mine 1
That noun did not make sense in this context.

>go to Southern District
You travel to the Southern District.

Southern District
A modern district, this urban sprawl is largely home to the middle professional class - those of the crisp suit, the anonymous hat, and the briefcase full of dull papers. To the north is the blackened spire of ZingCorp bank.

You can see a cab (empty) here.

>n
ZingCorp Bank
A twisting spire of some kind of black stone, this place is often referred to as the wizard's tower because of the affectations of the self-styled Grand Master Zing who runs it. To the north likes Silver Rush, to the south spreads the South District.

>s
Southern District
A modern district, this urban sprawl is largely home to the middle professional class - those of the crisp suit, the anonymous hat, and the briefcase full of dull papers. To the north is the blackened spire of ZingCorp bank.

You can see a cab (empty) here.

>get in cab
You climb into the cab. The driver says, "Where to sir?"

>n
You'd better get out first!

>go to block 16
That noun did not make sense in this context.

>go to southern district
You travel to the Southern District.

Southern District
A modern district, this urban sprawl is largely home to the middle professional class - those of the crisp suit, the anonymous hat, and the briefcase full of dull papers. To the north is the blackened spire of ZingCorp bank.

You can see a cab (empty) here.

>get out
But you aren't in anything at the moment.

>get in cab
You climb into the cab. The driver says, "Where to sir?"

>go to Archives
You travel to the Archives.

Archives
A marble monument to knowledge. DingCorp Bank is to the north, the Hospital to the west, Silver Rush to the south and the Job Centre to the east.

* * *

>i
You are carrying:
  an incursion scanner
  a notebook
  a map

>x scanner
A bulbous metal device, with apparently random wires sticking out of it and connecting to other parts. A copper billboard display, hundreds of tiny panels bearing letters and numbers, show the messages. A faint crystal luminesence glimmers in the gaps.

>x notebook
You check your notebook.

* * *

>w
Hospital
St. Clemens Hospital is a relatively modern construction. To the north lies PringCorp Bank, while a minor bank is to the south. The Archives lie east.

>heal
That's not a verb I recognise.

* * *

This is the introduction text. Type "help" to see the game rules and instructions.

Gates
An Interactive Fiction by S R Williams
Release 1 / Serial number 191010 / Inform 7 build 6M62 (I6/v6.33 lib 6/12N) SD

Archives
A marble monument to knowledge. DingCorp Bank is to the north, the Hospital to the west, Silver Rush to the south and the Job Centre to the east.

You can see a research device here.

>go to western
You travel to the Western District.

Western District
Colourful and vibrant, the Western District is deprived in wealth but rich in culture. To the east lies the brick block of PringCorp bank.

You can see a cab (empty) here.

>get in cab
You get into the cab.

>e
PringCorp Bank (in the cab)
An austere brick block of a building. To the west sprawls the Western District, to the south the Hospital

* * *

This is the introduction text. Type "help" to see the game rules and instructions.

Gates
An Interactive Fiction by S R Williams
Release 1 / Serial number 191010 / Inform 7 build 6M62 (I6/v6.33 lib 6/12N) SD

Archives
A marble monument to knowledge. DingCorp Bank is to the north, the Hospital to the west, Silver Rush to the south and the Job Centre to the east.

You can see a research device here.

>go to western district
You travel to the Western District.

Western District
Colourful and vibrant, the Western District is deprived in wealth but rich in culture. To the east lies the brick block of PringCorp bank.

You can see a cab (empty) here.

>get in cab
You get into the cab.

>e
You'd better get out first!

>w
You can't go that way.

>get out
You get out of the cab.

Western District
Colourful and vibrant, the Western District is deprived in wealth but rich in culture. To the east lies the brick block of PringCorp bank.

You can see a cab (empty) here.

* * *

This is the introduction text. Type "help" to see the game rules and instructions.

Gates
An Interactive Fiction by S R Williams
Release 1 / Serial number 191010 / Inform 7 build 6M62 (I6/v6.33 lib 6/12N) SD

Archives
A marble monument to knowledge. DingCorp Bank is to the north, the Hospital to the west, Silver Rush to the south and the Job Centre to the east.

You can see a research device here.

>help
Type "i" or "inventory" to see the list of items you are carrying. To interact with an object, you can generally type "use object" to do so; if you have to be more specific than this, the game will tell you.\n\nType "go to place" to go to a particular place, as indicated on your map (or by your memory); this also works in cabs to go to specific addresses you may have found. You can walk around town manually by going north, east, south or west too, if you want.; some areas may only be accessible via this method, as goto will take you to the "front" of the location in most cases, and there may be other places to explore.\n\nType "get object" or "pick up object" to pick something up and add it to your inventory.\n\nType "talk to person" to engage someone in conversation.

* * *

This is the introduction text. Type "help" to see the game rules and instructions.

Gates
An Interactive Fiction by S R Williams
Release 1 / Serial number 191010 / Inform 7 build 6M62 (I6/v6.33 lib 6/12N) SD

Archives
A marble monument to knowledge. DingCorp Bank is to the north, the Hospital to the west, Silver Rush to the south and the Job Centre to the east.

You can see a research device here.

>hel
That's not a verb I recognise.

>help
Type "i" or "inventory" to see the list of items you are carrying. To interact with an object, you can generally type "use object" to do so; if you have to be more specific than this, the game will tell you.

Type "go to place" to go to a particular place, as indicated on your map (or by your memory); this also works in cabs to go to specific addresses you may have found. You can walk around town manually by going north, east, south or west too, if you want.; some areas may only be accessible via this method, as goto will take you to the "front" of the location in most cases, and there may be other places to explore.

Type "get object" or "pick up object" to pick something up and add it to your inventory.

Type "talk to person" to engage someone in conversation.

>n
DingCorp Bank
An imposing corporate edifice. The Northern district sprawls to the north of here, while the Archives lie to the south.

>map
That's not a verb I recognise.

>use map
You can't see any such thing.

* * *

This is the introduction text. Type "help" to see the game rules and instructions.

Gates
An Interactive Fiction by S R Williams
Release 1 / Serial number 191010 / Inform 7 build 6M62 (I6/v6.33 lib 6/12N) SD

Archives
A marble monument to knowledge. DingCorp Bank is to the north, the Hospital to the west, Silver Rush to the south and the Job Centre to the east.

You can see a research device here.

>go to south district
That noun did not make sense in this context.

>go to southern district
You travel to the Southern District.

Southern District
A modern district, this urban sprawl is largely home to the middle professional class - those of the crisp suit, the anonymous hat, and the briefcase full of dull papers. To the north is the blackened spire of ZingCorp bank.

You can see a cab (empty) here.

>enter cab
You climb into the cab. The driver says, "Where to sir?"

>x driver
You can't see any such thing.

>x cab driver
I only understood you as far as wanting to examine the cab.

* * *

This is the introduction text. Type "help" to see the game rules and instructions.

Gates
An Interactive Fiction by S R Williams
Release 1 / Serial number 191010 / Inform 7 build 6M62 (I6/v6.33 lib 6/12N) SD

Archives
A marble monument to knowledge. DingCorp Bank is to the north, the Hospital to the west, Silver Rush to the south and the Job Centre to the east.

You can see a research device here.

>go to southern
Which do you mean, the Southern District or Southern Block?

>go to southern district
You travel to the Southern District.

Southern District
A modern district, this urban sprawl is largely home to the middle professional class - those of the crisp suit, the anonymous hat, and the briefcase full of dull papers. To the north is the blackened spire of ZingCorp bank.

You can see a cab (empty) here.

* * *

>x driver
You can't see any such thing.

>ask cab driver about food
You can only do that to something animate.

>ask driver about food
You can't see any such thing.

* * *

This is the introduction text. Type "help" to see the game rules and instructions.

Gates
An Interactive Fiction by S R Williams
Release 1 / Serial number 191010 / Inform 7 build 6M62 (I6/v6.33 lib 6/12N) SD

Archives
A marble monument to knowledge. DingCorp Bank is to the north, the Hospital to the west, Silver Rush to the south and the Job Centre to the east.

You can see a research device here.

>go to northern district
You travel to the Northern District.

Northern District
A vast maze of blocks stretching for miles, the Northern District is clean and green and houses the more affluent elements of the city. To the south is the impressive facde of DingCorp Bank.

You can see a cab (in which is a driver) here.

>enter cab
You climb into the cab. The driver says, "Where to sir?"

>x driver
You see nothing special about the driver.

>ask driver about paint
There is no reply.

>punch driver
Violence isn't the answer to this one.

>go to eastern block 16
That noun did not make sense in this context.

* * *

This is the introduction text. Type "help" to see the game rules and instructions.

Gates
An Interactive Fiction by S R Williams
Release 1 / Serial number 191010 / Inform 7 build 6M62 (I6/v6.33 lib 6/12N) SD

Archives
A marble monument to knowledge. DingCorp Bank is to the north, the Hospital to the west, Silver Rush to the south and the Job Centre to the east.

You can see a research device here.

>go to Archives
You travel to the Archives.

Archives
A marble monument to knowledge. DingCorp Bank is to the north, the Hospital to the west, Silver Rush to the south and the Job Centre to the east.

>go to Prospector
I don't know where that is.

* * *

>go to DingCorp Bank
I don't know where that is.

>go to Hospital
I don't know where that is.

>go to Minor Bank
Which do you mean, Minor Bank 1, Minor Bank 2, Minor Bank 3 or Minor Bank 4?

>go to Minor Bank 1
I don't know where that is.

* * *

>go to Archives
You travel to the Archives.

Archives
A marble monument to knowledge. DingCorp Bank is to the north, the Hospital to the west, Silver Rush to the south and the Job Centre to the east.

>go to Minor Bank 1
You travel to Minor Bank 1.

Minor Bank 1
A drab and beaurocratic affair, with a sign that reads "Clemens and Co.". To the north lies the Hospital.

>x ma
You can't see any such thing.

* * *

>go to Mine 2
You travel to Mine 2.

Mine 2

>go to Hospital
You travel to the Hospital.

Hospital
St. Clemens Hospital is a relatively modern construction. To the north lies PringCorp Bank, while a minor bank is to the south. The Archives lie east.

>go to Fart
That noun did not make sense in this context.

>go to my face
That noun did not make sense in this context.

>go to Prospector's
You travel to the Prospector's Guild.

Prospector's Guild
A somewhat ramshackle affair that belies the incredible wealth that the guild controls. In some sense, all of the city revolves around this place. To the south is the Job Cenre, while to the east is a minor bank.

>s
Job Centre
A squat block, this place is the place where protifable business actions are transacted - for a fee, of course. The the west lies the Archives, to the north the Prospector's Guild, to the south the Training complex, and to the east a minor bank.

>w
Archives
A marble monument to knowledge. DingCorp Bank is to the north, the Hospital to the west, Silver Rush to the south and the Job Centre to the east.

>map
That's not a verb I recognise.

>x ma
You can't see any such thing.

* * *

>s
Silver Rush
This unassuming place is not to be underestimated - it contains a huge collection of the latest gadgets and you can usually find a good deal. Burly guards lounge threateningly. To the north lies the sparkling marble of the Archives, to the south the spire of ZingCorp Bank.

>n, e, s
Archives
A marble monument to knowledge. DingCorp Bank is to the north, the Hospital to the west, Silver Rush to the south and the Job Centre to the east.

Job Centre
A squat block, this place is the place where protifable business actions are transacted - for a fee, of course. The the west lies the Archives, to the north the Prospector's Guild, to the south the Training complex, and to the east a minor bank.

Training
The foremost self-improvement place in the city, the simply-named Training has numerous instructors, courses and apparatues ready to test and extend your skills and knowledge - for a fee, of course. To the north lies the Job Centre, to the east a minor bank.

* * *

This is the introduction text. Type "help" to see the game rules and instructions.

Gates
An Interactive Fiction by S R Williams
Release 1 / Serial number 191010 / Inform 7 build 6M62 (I6/v6.33 lib 6/12N) SD

Archives
A marble monument to knowledge. DingCorp Bank is to the north, the Hospital to the west, Silver Rush to the south and the Job Centre to the east.

You can see a research device here.

>go to fart
You talk to the wind. But the wind cannot does not hear; the wind cannot hear.

>go to mapp
You can't see any such thing.

>go to ma[
You can't see any such thing.

>go to map
You can't see any such thing.

* * *

>go to fart
You talk to the wind. But the wind cannot does not hear; the wind cannot hear.

>map
That's not a verb I recognise.

* * *

>n, n
DingCorp Bank
An imposing corporate edifice. The Northern district sprawls to the north of here, while the Archives lie to the south.

Northern District
A vast maze of blocks stretching for miles, the Northern District is clean and green and houses the more affluent elements of the city. To the south is the impressive facde of DingCorp Bank.

You can see a cab (in which is a driver) here.

>go to fart
You talk to the wind. But the wind cannot does not hear; the wind cannot hear.

>enter cab
You climb into the cab. The driver says, "Where to sir?"

>go to lace
"Sorry, I don't know where that is."

>ask driver about having sex with lemons
There is no reply.

>tell driver to go fuck himself
I didn't understand that sentence.

>tell driver about fucking
This provokes no reaction.

>go to Archives
"Sorry, I don't know where that is."

* * *

This is the introduction text. Type "help" to see the game rules and instructions.

Gates
An Interactive Fiction by S R Williams
Release 1 / Serial number 191010 / Inform 7 build 6M62 (I6/v6.33 lib 6/12N) SD

Archives
A marble monument to knowledge. DingCorp Bank is to the north, the Hospital to the west, Silver Rush to the south and the Job Centre to the east.

You can see a research device here.

>go shitburgh
I don't know where that is.

* * *

This is the introduction text. Type "help" to see the game rules and instructions.

Gates
An Interactive Fiction by S R Williams
Release 1 / Serial number 191010 / Inform 7 build 6M62 (I6/v6.33 lib 6/12N) SD

Archives
A marble monument to knowledge. DingCorp Bank is to the north, the Hospital to the west, Silver Rush to the south and the Job Centre to the east.

You can see a research device here.

>n, n
DingCorp Bank
An imposing corporate edifice. The Northern district sprawls to the north of here, while the Archives lie to the south.

Northern District
A vast maze of blocks stretching for miles, the Northern District is clean and green and houses the more affluent elements of the city. To the south is the impressive facde of DingCorp Bank.

You can see a cab (in which is a driver) here.

>enter cab
You climb into the cab. The driver says, "Where to?"

>go to Eastern District 17
"Sorry, I don't know where that is."

* * *

>enter cab
You climb into the cab. The driver says, "Where to?"

>go to SD-1
"Sorry, I don't know where that is."

>go to SD-01
"Sure!" The cab moves off.

"So what about them Yankees eh? Some game!"

The cab pulls up at your destination, and you pay the driver $4.16.

Urban Sprawl
You are deep within the maze of urban life,. A sign nearby reads gloopy gloo SD-01.

You can see a cab (in which is a driver) here.

>look
Urban Sprawl
You are deep within the maze of urban life,. A sign nearby reads gloopy gloo 
*** Run-time problem P39: Attempt to say a snippet value which is currently invalid: words 3 to 3.

.

You can see a cab (in which is a driver) here.

* * *

>enter cab
You climb into the cab. The driver says, "Where to?"

>go to ED-12
"Sure!" The cab moves off. After a time, the cab pulls up at your destination. You pay the driver and get out.

Urban Sprawl
You are deep within the maze of urban life,. A sign nearby reads ED-12.

You can see a cab (in which is a driver) here.

>go city
You talk to the wind. But the wind does not hear; the wind cannot hear.

>enter cab
You climb into the cab. The driver says, "Where to sir?"

>go city
"Sorry, I don't know where that is."

>go to city centre
"Sorry, I don't know where that is."

* * *

>go to ED-12
"Sure!" The cab moves off. After a time, the cab pulls up at your destination. You pay the driver and get out.

Urban Sprawl
You are deep within the maze of urban life,. A sign nearby reads ED-12.

You can see a cab (in which is a driver) here.

>go to city centre
You talk to the wind. But the wind does not hear; the wind cannot hear.

>enter cab
You climb into the cab. The driver says, "Where to sir?"

>go to city centre
"Sorry, I don't know where that is."

* * *

>enter cab
You climb into the cab. The driver says, "Where to?"

>go to ED-01
ED-01.
"Sure!" The cab moves off. After a time, the cab pulls up at your destination. You pay the driver and get out.

Urban Sprawl
You are deep within the maze of urban life,. A sign nearby reads ED-01.

You can see a cab (in which is a driver) here.

* * *

>go to ND-12
"Sure!" The cab moves off. After a time, the cab pulls up at your destination. You pay the driver and get out.

Urban Sprawl
You are deep within the maze of urban life,. A sign nearby reads ND-12.

You can see a cab (in which is a driver) here.

>investigate
You have found Bob Jones!

>get in cab
You climb into the cab. The driver says, "Where to sir?"

>go to SD-14
"Sure!" The cab moves off. After a time, the cab pulls up at your destination. You pay the driver and get out.

Urban Sprawl
You are deep within the maze of urban life,. A sign nearby reads SD-14.

You can see a cab (in which is a driver) here.

>investigate
You have found Bill Speck!

>get in cab
You climb into the cab. The driver says, "Where to sir?"

>go to ED-01
"Sure!" The cab moves off. After a time, the cab pulls up at your destination. You pay the driver and get out.

Urban Sprawl
You are deep within the maze of urban life,. A sign nearby reads ED-01.

You can see a cab (in which is a driver) here.

* * *

>enter cab
You climb into the cab. The driver says, "Where to?"

>go to SD-12
"Sure!" The cab moves off. After a time, the cab pulls up at your destination. You pay the driver and get out.

Urban Sprawl
You are deep within the maze of urban life,. A sign nearby reads SD-12.

You can see a cab (in which is a driver) here.

>investigate
You thoroughly search the area, but come up empy handed.

>enter cab
You climb into the cab. The driver says, "Where to sir?"

>go to SD-14
"Sure!" The cab moves off. After a time, the cab pulls up at your destination. You pay the driver and get out.

Urban Sprawl
You are deep within the maze of urban life,. A sign nearby reads SD-14.

You can see a cab (in which is a driver) here.

>investigate
You thoroughly search the area. You have found Bill Speck!

>look
Urban Sprawl
You are deep within the maze of urban life,. A sign nearby reads SD-14.

You can see a Bill Speck and a cab (in which is a driver) here.

* * *

>investigate
You thoroughly search the area. You have found Bill Speck!

>x Bill
You see nothing special about Bill Speck.

>enter cab
You climb into the cab. The driver says, "Where to sir?"

>go to ND-12
"Sure!" The cab moves off. After a time, the cab pulls up at your destination. You pay the driver and get out.

Urban Sprawl
You are deep within the maze of urban life,. A sign nearby reads ND-12.

You can see a cab (in which is a driver) here.

>go to SD-14
You talk to the wind. But the wind does not hear; the wind cannot hear.

>investigate
You thoroughly search the area. You have found Bob Jones!

>x Bob
You see nothing special about Bob Jones.

>enter cab
You climb into the cab. The driver says, "Where to sir?"

>go to ED-01
"Sure!" The cab moves off. After a time, the cab pulls up at your destination. You pay the driver and get out.

Urban Sprawl
You are deep within the maze of urban life,. A sign nearby reads ED-01.

You can see a cab (in which is a driver) here.

>investigate
You thoroughly search the area, but come up empy handed.

>l
Urban Sprawl
You are deep within the maze of urban life,. A sign nearby reads ED-01.

You can see a cab (in which is a driver) here.

* * *

>enter cab
You climb into the cab. The driver says, "Where to?"

>go to SD-14
"Sure!" The cab moves off. After a time, the cab pulls up at your destination. You pay the driver and get out.

Urban Sprawl
You are deep within the maze of urban life,. A sign nearby reads SD-14.

You can see a cab (in which is a driver) here.

* * *

>investigate
You thoroughly search the area. You have found Bill Speck!

>look
Urban Sprawl
You are deep within the maze of urban life,. A sign nearby reads SD-14.

You can see Bill Speck and a cab (in which is a driver) here.

>ask Bill Speck about sex
You can't see any such thing.

>ask Bill about sex
You can't see any such thing.

* * *

>enter cab
You climb into the cab. The driver says, "Where to?"

>go to ED-67
"Sure!" The cab moves off. After a time, the cab pulls up at your destination. You pay the driver and get out.

Urban Sprawl
You are deep within the maze of urban life,. A sign nearby reads ED-67.

You can see a cab (in which is a driver) here.

>search
You thoroughly search the area. You have found Emily Yang!

>confront emily
Emily is happy to talk to you.
"Bob Jones has family that lives in the North District, between block 10 and 15 I think."

>thanks
That's not a verb I recognise.

>thank emily
That's not a verb I recognise.

>get into cab
You climb into the cab. The driver says, "Where to?"

>go to WD-80
"Sure!" The cab moves off. After a time, the cab pulls up at your destination. You pay the driver and get out.

Urban Sprawl
You are deep within the maze of urban life,. A sign nearby reads WD-80.

You can see a cab (in which is a driver) here.

>search
You thoroughly search the area. You have found Jim Juke!

>confront
(Jim Juke)
You persuade Jim!
"OK, I guess... Last I knew, Belinda Speck was hiding in SD-14."

>get into cab
You climb into the cab. The driver says, "Where to?"

>go to SD-14
"Sure!" The cab moves off. After a time, the cab pulls up at your destination. You pay the driver and get out.

Urban Sprawl
You are deep within the maze of urban life,. A sign nearby reads SD-14.

You can see a cab (in which is a driver) here.

>search
You thoroughly search the area. You have found Belinda Speck!

>confront Belinda
You beat up Belinda!
OK, OK! "I know the code fragment D6 is at position 4."

>get into cab
You climb into the cab. The driver says, "Where to?"

>go to ND-12
"Sure!" The cab moves off. After a time, the cab pulls up at your destination. You pay the driver and get out.

Urban Sprawl
You are deep within the maze of urban life,. A sign nearby reads ND-12.

You can see a cab (in which is a driver) here.

* * *

>search
You thoroughly search the area. You have found Bob Jones!

>confront Bob
You fail to persuade Bob. They walk away, looking agitated.

>l
Urban Sprawl
You are deep within the maze of urban life,. A sign nearby reads ND-12.

You can see a cab (in which is a driver) here.

>search
You thoroughly search the area. You have found Bob Jones!

* * *

>confront Bob
You fail to persuade Bob. They walk away, looking agitated.

>search
You thoroughly search the area. You have found Bob Jones!

>confront Bob
You persuade Bob!
"OK, I guess... I know the code fragment A1 is at position 10."

* * *

>go to mine
"Sure!" The cab drives off. After a time it arrives at the mine on the outskirts of the city. You pay the driver and get out.

Crystal Mine
A rent in the earth disapears into a darkness ahead of you, leading into an underground labyrinth. Precious crystals are here for the taking.

You can see a cab (in which is a driver) here.

>mine
You enter the opening and descend into the darkness. Outside of the tiny illuminated sphere of your flickering yellow lamp light, it is pitck dark.
After some time, you detect the strange ethereal glow of your quarry ahead! You dig out the cache, taking 5 crystals.

>mine
You enter the opening and descend into the darkness. Outside of the tiny illuminated sphere of your flickering yellow lamp light, it is pitck dark.
After some time, you detect the strange ethereal glow of your quarry ahead! You dig out the cache, taking 2 crystals.

>l
Crystal Mine
You can see a cab (in which is a driver) here.

* * *

>mine
You enter the opening and descend into the darkness. Outside of the tiny illuminated sphere of your flickering yellow lamp light, it is pitck dark.
After some time, you detect the strange ethereal glow of your quarry ahead! You dig out the cache, taking 2 crystals.

>mine
You enter the opening and descend into the darkness. Outside of the tiny illuminated sphere of your flickering yellow lamp light, it is pitck dark.
After some time, you detect the strange ethereal glow of your quarry ahead! You dig out the cache, taking 1 crystals.

>mine
You enter the opening and descend into the darkness. Outside of the tiny illuminated sphere of your flickering yellow lamp light, it is pitck dark.
You wander the caverns, but can find nothing of interest. You return to the daylight.

>s
You can't go that way.

>l
Crystal Mine
A rent in the earth disapears into a darkness ahead of you, leading into an underground labyrinth. Precious crystals are here for the taking.

You can see a cab (in which is a driver) here.

* * *

>go to city
"Sure!" The cab returns to the centre of town. You pay the driver and get out.

Northern District
A vast maze of blocks stretching for miles, the Northern District is clean and green and houses the more affluent elements of the city. To the south is the impressive facde of DingCorp Bank.

You can see a cab (in which is a driver) here.

>s
DingCorp Bank
An imposing corporate edifice. The Northern district sprawls to the north of here, while the Archives lie to the south.

* * *

>s
Archives
A marble monument to knowledge. DingCorp Bank is to the north, the Hospital to the west, Silver Rush to the south and the Job Centre to the east.

You can see a research device here.

>i
You are carrying:
  an incursion scanner
  a notebook
  a map

I beg your pardon?

>sell
That's not a verb I recognise.

* * *

>n, n
DingCorp Bank
An imposing corporate edifice. The Northern district sprawls to the north of here, while the Archives lie to the south.

Northern District
A vast maze of blocks stretching for miles, the Northern District is clean and green and houses the more affluent elements of the city. To the south is the impressive facde of DingCorp Bank.

You can see a cab (in which is a driver) here.

>get in cab
You climb into the cab. The driver says, "Where to?"

>go to fart
fart"Sorry, I don't know where that is."

>go to Eastern District 17
Eastern District 17"Sorry, I don't know where that is."

* * *

>get in cab
You climb into the cab. The driver says, "Where to?"

>go Eastern District 17
Eastern District 17"Sure!"

>go Eastern District 16
Eastern District 16"Sorry, I don't know where that is."

* * *

>get in cab
You climb into the cab. The driver says, "Where to?"

>go to SD-14
"Sure!" The cab moves off. After a time, the cab pulls up at your destination. You pay the driver and get out.

Urban Sprawl
You are deep within the maze of urban life,. A sign nearby reads SD-14.

You can see a cab (in which is a driver) here.

* * *

>search
You thoroughly search the area. You have found Belinda Speck!

>confront
(Belinda Speck)
You are beaten up by Belinda. They get away!

>confront
(the driver)
You angrily berate the driver, but it doesn't make any difference.

>l
Urban Sprawl
You are deep within the maze of urban life,. A sign nearby reads SD-14.

You can see a cab (in which is a driver) here.

>punch driver
Violence isn't the answer to this one.

>search
You thoroughly search the area. You have found Belinda Speck!

* * *

>confront
(Belinda Speck)
You are beaten up by Belinda. They get away!

>search
You thoroughly search the area. You have found Belinda Speck!

>confront
(Belinda Speck)
You beat up Belinda!
OK, OK! "I know the code fragment D6 is at position 4".

>go to city
You talk to the wind. But the wind does not hear; the wind cannot hear.

>get into cab
You climb into the cab. The driver says, "Where to?"

>go to city
"Sure!" The cab returns to the centre of town. You pay the driver and get out.

Northern District
A vast maze of blocks stretching for miles, the Northern District is clean and green and houses the more affluent elements of the city. To the south is the impressive facde of DingCorp Bank.

You can see a cab (in which is a driver) here.

* * *

>s
DingCorp Bank
An imposing corporate edifice. The Northern district sprawls to the north of here, while the Archives lie to the south.

>s
Archives
A marble monument to knowledge. DingCorp Bank is to the north, the Hospital to the west, Silver Rush to the south and the Job Centre to the east.

You can see a research device here.

>mapp
That's not a verb I recognise.

>x mapp
You can't see any such thing.

>x ma
You can't see any such thing.

* * *

>e, s
Job Centre
A squat block, this place is the place where protifable business actions are transacted - for a fee, of course. The the west lies the Archives, to the north the Prospector's Guild, to the south the Training complex, and to the east a minor bank.

Training
The foremost self-improvement place in the city, the simply-named Training has numerous instructors, courses and apparatues ready to test and extend your skills and knowledge - for a fee, of course. To the north lies the Job Centre, to the east a minor bank.

You can see an a desk (on which is a course book) here.

* * *

>go to SD-14
"Sure!" The cab moves off. After a time, the cab pulls up at your destination. You pay the driver and get out.

Urban Sprawl
You are deep within the maze of urban life,. A sign nearby reads SD-14.

You can see a cab (in which is a driver) here.

>investigate
You thoroughly search the area. You have found Belinda Speck!

>confront Belinda
You beat up Belinda!

>confront Belinda
You are beaten up by Belinda.

>confront Belinda
You are beaten up by Belinda.

>confront Belinda
You beat up Belinda!

>confront Belinda
You beat up Belinda!

>get in cab
You climb into the cab. The driver says, "Where to?"

>go to WD-80
"Sure!" The cab moves off. After a time, the cab pulls up at your destination. You pay the driver and get out.

Urban Sprawl
You are deep within the maze of urban life,. A sign nearby reads WD-80.

You can see a cab (in which is a driver) here.

* * *

>search
You thoroughly search the area. You have found Jim Juke!

>confront Ji,
You can't see any such thing.

>confront Jim
59, 17
You fail to persuade Jim.

>confront Jim
26, -34
You fail to persuade Jim.

>confront Jim
55, -13
You fail to persuade Jim.

>confront Jim
11, 9
You fail to persuade Jim.

>confront Jim
35, -13
You fail to persuade Jim.

>confront Jim
-9, -65
You fail to persuade Jim.

>confront Jim
-12, 24
You persuade Jim!

>confront Jim
62, -34
You fail to persuade Jim.

>confront Jim
40, -2
You fail to persuade Jim.

>confront Jim
-16, -59
You fail to persuade Jim.

>confront Jim
-14, -28
You fail to persuade Jim.

>confront Jim
22, 9
You fail to persuade Jim.

>confront Jim
42, 3
You fail to persuade Jim.

>get in car
You can't see any such thing.

>get in cab
You climb into the cab. The driver says, "Where to?"

>go to ED-67
"Sure!" The cab moves off. After a time, the cab pulls up at your destination. You pay the driver and get out.

Urban Sprawl
You are deep within the maze of urban life,. A sign nearby reads ED-67.

You can see a cab (in which is a driver) here.

* * *

>search
You thoroughly search the area. You have found Emily Yang!

>l
Urban Sprawl
You are deep within the maze of urban life,. A sign nearby reads ED-67.

You can see Emily Yang and a cab (in which is a driver) here.

>x Emily
You see nothing special about Emily Yang.

>confront Emil
You can't see any such thing.

* * *

>get in cab
You climb into the cab. The driver says, "Where to?"

>go to ND-12
"Sure!" The cab moves off. After a time, the cab pulls up at your destination. You pay the driver and get out.

Urban Sprawl
You are deep within the maze of urban life,. A sign nearby reads ND-12.

You can see a cab (in which is a driver) here.

* * *

>search
You thoroughly search the area. You have found Bob Jones!

>confront Bob
You persuade Bob!

>confront Bob
You persuade Bob!

>confront Bob
You fail to persuade Bob.

>confront Bob
You persuade Bob!

>get into cab
You climb into the cab. The driver says, "Where to?"

* * *

>n, n
DingCorp Bank
An imposing corporate edifice. The Northern district sprawls to the north of here, while the Archives lie to the south.

Northern District
A vast maze of blocks stretching for miles, the Northern District is clean and green and houses the more affluent elements of the city. To the south is the impressive facde of DingCorp Bank.

You can see a cab (in which is a driver) here.

>get into cab
You climb into the cab. The driver says, "Where to?"

>go to fart
"Sorry, I don't know where that is."

>go to ED asduaifdh 16
"Sorry, I don't know where that is."

>go to ED 16
"Sorry, I don't know where that is."

* * *

>go to ND-12
"Sure!" The cab moves off. After a time, the cab pulls up at your destination. You pay the driver and get out.

Urban Sprawl
You are deep within the maze of urban life,. A sign nearby reads ND-12.

You can see a cab (in which is a driver) here.

>look
Urban Sprawl
You are deep within the maze of urban life,. A sign nearby reads ND-12.

You can see a cab (in which is a driver) here.

>investigate
You thoroughly search the area. You have found Bob Jones!

* * *

>x Bob
You see nothing special about Bob Jones.

>punch bob
Violence isn't the answer to this one.

>kiss Bob
Bob Jones might not like that.

>enter cab
You climb into the cab. The driver says, "Where to sir?"

>go to SD-14
"Sure!" The cab moves off. After a time, the cab pulls up at your destination. You pay the driver and get out.

Urban Sprawl
You are deep within the maze of urban life,. A sign nearby reads SD-14.

You can see Bob Jones and a cab (in which is a driver) here.

* * *

>confront
(Belinda Speck)
You are beaten up by Belinda. They get away!

>confront
(the driver)
You angrily berate yourself, but it doesn't make any difference.

* * *

>get in
You climb into the cab. The driver says, "Where to sir?"

>go to ed-34
"Sorry, I don't know where that is."

>go to ED-34
"Sure!" The cab moves off.

"So what about them Yankees eh? Some game!"

The cab pulls up at your destination, and you pay the driver $4.16.

>look
Northern District (in the cab)
A vast maze of blocks stretching for miles, the Northern District is clean and green and houses the more affluent elements of the city. To the south is the impressive facde of DingCorp Bank.

In the cab you can see a driver.

>exit
You get out of the cab.

Northern District
A vast maze of blocks stretching for miles, the Northern District is clean and green and houses the more affluent elements of the city. To the south is the impressive facde of DingCorp Bank.

You can see a cab (in which is a driver) here.

* * *

>n, n
DingCorp Bank
An imposing corporate edifice. The Northern district sprawls to the north of here, while the Archives lie to the south.

Northern District
A vast maze of blocks stretching for miles, the Northern District is clean and green and houses the more affluent elements of the city. To the south is the impressive facde of DingCorp Bank.

You can see a cab (in which is a driver) here.

>get in car
You can't see any such thing.

>get in cab
You climb into the cab. The driver says, "Where to sir?"

>go to nd-23
"Sorry, I don't know where that is."

>go to ND-23
"Sure!" The cab moves off.

"So what about them Yankees eh? Some game!"

The cab pulls up at your destination, and you pay the driver $4.16.

Urban Sprawl
You are deep within the maze of urban life, at address ND-23.

>n
You can't go that way.

* * *

>w
You can't go that way.

>s
You can't go that way.

* * *

This is the introduction text. Type "help" to see the game rules and instructions.

Gates
An Interactive Fiction by S R Williams
Release 1 / Serial number 191010 / Inform 7 build 6M62 (I6/v6.33 lib 6/12N) SD

Archives
A marble monument to knowledge. DingCorp Bank is to the north, the Hospital to the west, Silver Rush to the south and the Job Centre to the east.

You can see a research device here.

I beg your pardon?

>go to ED 15
You talk to the wind. But the wind does not hear; the wind cannot hear.

>n, n
DingCorp Bank
An imposing corporate edifice. The Northern district sprawls to the north of here, while the Archives lie to the south.

Northern District
A vast maze of blocks stretching for miles, the Northern District is clean and green and houses the more affluent elements of the city. To the south is the impressive facde of DingCorp Bank.

You can see a cab (in which is a driver) here.

>get in cab
You climb into the cab. The driver says, "Where to sir?"

>go to ED 16
"Sure!" The cab moves off.
"So what about them Yankees eh? Some game!"
The cab pulls up at your destination, and you pay the driver $4.16.

>go to ND 12
"Sorry, I don't know where that is."

* * *

I beg your pardon?

>n,n
DingCorp Bank
An imposing corporate edifice. The Northern district sprawls to the north of here, while the Archives lie to the south.

Northern District
A vast maze of blocks stretching for miles, the Northern District is clean and green and houses the more affluent elements of the city. To the south is the impressive facde of DingCorp Bank.

You can see a cab (in which is a driver) here.

* * *

>enter cab
You climb into the cab. The driver says, "Where to?"

>go to mine
"Sure!" The cab drives off. After a time it arrives at the mine on the outskirts of the city. You pay the driver and get out.

Crystal Mine
A rent in the earth disapears into a darkness ahead of you, leading into an underground labyrinth. Precious crystals are here for the taking. (type "mine" to explore the mine).

You can see a cab (in which is a driver) here.

>mine
You enter the opening and descend into the darkness. Outside of the tiny illuminated sphere of your flickering yellow lamp light, it is pitck dark.
After some time, you detect the strange ethereal glow of Crystals ahead! You dig out as much as you can and return to the surface.

>mine
You enter the opening and descend into the darkness. Outside of the tiny illuminated sphere of your flickering yellow lamp light, it is pitck dark.
You wander the caverns, but can find nothing of interest. You return to the daylight.

* * *

This is the introduction text. Type "help" to see the game rules and instructions.

Gates
An Interactive Fiction by S R Williams
Release 1 / Serial number 191010 / Inform 7 build 6M62 (I6/v6.33 lib 6/12N) SD

Archives
A marble monument to knowledge. DingCorp Bank is to the north, the Hospital to the west, Silver Rush to the south and the Job Centre to the east.

You can see a research device here.

>n, n, get in cab
DingCorp Bank
An imposing corporate edifice. The Northern district sprawls to the north of here, while the Archives lie to the south.

Northern District
A vast maze of blocks stretching for miles, the Northern District is clean and green and houses the more affluent elements of the city. To the south is the impressive facde of DingCorp Bank.

You can see a cab (in which is a driver) here.

You climb into the cab. The driver says, "Where to sir?"

>go to ED
[** Programming error: tried to read from -->-1 in the array "parse", which has entries 0 up to 60 **]
"Sorry, I don't know where that is."

>go to ED 16
"Sorry, I don't know where that is."

>go to 14
"Sorry, I don't know where that is."

>go to ND 12
"Sorry, I don't know where that is."

>go to SD
[** Programming error: tried to read from -->-1 in the array "parse", which has entries 0 up to 60 **]
"Sorry, I don't know where that is."

* * *

>n, n, get in cab
DingCorp Bank
An imposing corporate edifice. The Northern district sprawls to the north of here, while the Archives lie to the south.

Northern District
A vast maze of blocks stretching for miles, the Northern District is clean and green and houses the more affluent elements of the city. To the south is the impressive facde of DingCorp Bank.

You can see a cab (in which is a driver) here.

You climb into the cab. The driver says, "Where to sir?"

>go to ED-12
"Sure!" The cab moves off.
"So what about them Yankees eh? Some game!"
The cab pulls up at your destination, and you pay the driver $4.16.

>go to fart
"Sorry, I don't know where that is."

>go to nd-12345
"Sorry, I don't know where that is."

>go to nd-99
"Sure!" The cab moves off.
"So what about them Yankees eh? Some game!"
The cab pulls up at your destination, and you pay the driver $4.16.

* * *

This is the introduction text. Type "help" to see the game rules and instructions.

Gates
An Interactive Fiction by S R Williams
Release 1 / Serial number 191010 / Inform 7 build 6M62 (I6/v6.33 lib 6/12N) SD

Archives
A marble monument to knowledge. DingCorp Bank is to the north, the Hospital to the west, Silver Rush to the south and the Job Centre to the east.

You can see a research device here.

>n, n,
DingCorp Bank
An imposing corporate edifice. The Northern district sprawls to the north of here, while the Archives lie to the south.

Northern District
A vast maze of blocks stretching for miles, the Northern District is clean and green and houses the more affluent elements of the city. To the south is the impressive facde of DingCorp Bank.

You can see a cab (in which is a driver) here.

>get in cab
You climb into the cab. The driver says, "Where to sir?"

>go to ED
"Sure!" The cab moves off.
"So what about them Yankees eh? Some game!"
The cab pulls up at your destination, and you pay the driver $4.16.

>go to SD
"Sure!" The cab moves off.
"So what about them Yankees eh? Some game!"
The cab pulls up at your destination, and you pay the driver $4.16.

>go to fart
"Sorry, I don't know where that is."

>go to asudhaisdh ED
"Sorry, I don't know where that is."

* * *

This is the introduction text. Type "help" to see the game rules and instructions.

Gates
An Interactive Fiction by S R Williams
Release 1 / Serial number 191010 / Inform 7 build 6M62 (I6/v6.33 lib 6/12N) SD

Archives
A marble monument to knowledge. DingCorp Bank is to the north, the Hospital to the west, Silver Rush to the south and the Job Centre to the east.

You can see a research device here.

>n, n, enter cab, go to ND-12
DingCorp Bank
An imposing corporate edifice. The Northern district sprawls to the north of here, while the Archives lie to the south.

Northern District
A vast maze of blocks stretching for miles, the Northern District is clean and green and houses the more affluent elements of the city. To the south is the impressive facde of DingCorp Bank.

You can see a cab (in which is a driver) here.

You can't use multiple objects with that verb.

>enter cab
You climb into the cab. The driver says, "Where to sir?"

>go to ND-12
"Sure!" The cab moves off.

"So what about them Yankees eh? Some game!"

The cab pulls up at your destination, and you pay the driver $4.16.

Urban Sprawl
You are deep within the maze of urban life, at address ND-12.

You can see a cab (in which is a driver) here.

>e
You can't go that way.

>get in cab
You climb into the cab. The driver says, "Where to sir?"

>ED-24
That's not a verb I recognise.

>go to ED-24 please
"Sorry, I don't know where that is."

>go to ED-24
"Sure!" The cab moves off.

"So what about them Yankees eh? Some game!"

The cab pulls up at your destination, and you pay the driver $4.16.

Urban Sprawl
You are deep within the maze of urban life, at address ED-24.

You can see a cab (in which is a driver) here.

>go to Northern District
You talk to the wind. But the wind does not hear; the wind cannot hear.

>l
Urban Sprawl
You are deep within the maze of urban life, at address 
*** Run-time problem P39: Attempt to say a snippet value which is currently invalid: words 3 to 4.

.

You can see a cab (in which is a driver) here.

I beg your pardon?

>look
Urban Sprawl
You are deep within the maze of urban life, at address 
*** Run-time problem P39: Attempt to say a snippet value which is currently invalid: words 3 to 4.

.

You can see a cab (in which is a driver) here.

>enter cab
You climb into the cab. The driver says, "Where to sir?"

>go to SD-1
"Sorry, I don't know where that is."

>go to SD-01
"Sure!" The cab moves off.

"So what about them Yankees eh? Some game!"

The cab pulls up at your destination, and you pay the driver $4.16.

Urban Sprawl
You are deep within the maze of urban life, at address SD-01.

You can see a cab (in which is a driver) here.

>look
Urban Sprawl
You are deep within the maze of urban life, at address 
*** Run-time problem P39: Attempt to say a snippet value which is currently invalid: words 3 to 3.

.

You can see a cab (in which is a driver) here.

* * *

This is the introduction text. Type "help" to see the game rules and instructions.

Gates
An Interactive Fiction by S R Williams
Release 1 / Serial number 191010 / Inform 7 build 6M62 (I6/v6.33 lib 6/12N) SD

Archives
A marble monument to knowledge. DingCorp Bank is to the north, the Hospital to the west, Silver Rush to the south and the Job Centre to the east.

You can see a research device here.

>n,n
DingCorp Bank
An imposing corporate edifice. The Northern district sprawls to the north of here, while the Archives lie to the south.

Northern District
A vast maze of blocks stretching for miles, the Northern District is clean and green and houses the more affluent elements of the city. To the south is the impressive facde of DingCorp Bank.

You can see a cab (in which is a driver) here.

* * *

>enter cab
You climb into the cab. The driver says, "Where to?"

>go to SD-13
"Sure!" The cab moves off.

"So what about them Yankees eh? Some game!"

The cab pulls up at your destination, and you pay the driver $4.16.

Urban Sprawl
You are deep within the maze of urban life,. A sign nearby reads SD-13.

You can see a cab (in which is a driver) here.

>look
Urban Sprawl
You are deep within the maze of urban life,. A sign nearby reads SD-13.

You can see a cab (in which is a driver) here.

>get out
But you aren't in anything at the moment.

>enter cab
You climb into the cab. The driver says, "Where to sir?"

>ask driver about scientists
There is no reply.

>go to SD-56
"Sure!" The cab moves off.

"So what about them Yankees eh? Some game!"

The cab pulls up at your destination, and you pay the driver $4.16.

Urban Sprawl
You are deep within the maze of urban life,. A sign nearby reads SD-56.

You can see a cab (in which is a driver) here.

* * *

>go to mine
"Sure!" The cab drives off. After a time it arrives at the mine on the outskirts of the city. You pay the driver and get out.

Crystal Mine
A rent in the earth disapears into a darkness ahead of you, leading into an underground labyrinth. Precious crystals are here for the taking. (type "mine" to explore the mine).

You can see a cab (in which is a driver) here.

>mine
You enter the opening and descend into the darkness. Outside of the tiny illuminated sphere of your flickering yellow lamp light, it is pitck dark.
You wander the caverns, but can find nothing of interest. You return to the daylight.

>l
Crystal Mine
A rent in the earth disapears into a darkness ahead of you, leading into an underground labyrinth. Precious crystals are here for the taking. (type "mine" to explore the mine).

You can see a cab (in which is a driver) here.

>enter cab
You climb into the cab. The driver says, "Where to?"

* * *

>s
Archives
A marble monument to knowledge. DingCorp Bank is to the north, the Hospital to the west, Silver Rush to the south and the Job Centre to the east.

You can see a research device here.

>use research
You sit down and begin to check the records. Time passes as you fall into your task, the clacking of the typeboard and the whoosh of arriving papers sinking into your subconcious.

You sit back for a break. Nothing so far.

* * *

This is the introduction text. Type "help" to see the game rules and instructions.

Gates
An Interactive Fiction by S R Williams
Release 1 / Serial number 191010 / Inform 7 build 6M62 (I6/v6.33 lib 6/12N) SD

Archives
A marble monument to knowledge. DingCorp Bank is to the north, the Hospital to the west, Silver Rush to the south and the Job Centre to the east.

You can see a research device here.

>x mapp
You can't see any such thing.

* * *

>w, n, w
Hospital
St. Clemens Hospital is a relatively modern construction. To the north lies PringCorp Bank, while a minor bank is to the south. The Archives lie east.

PringCorp Bank
An austere brick block of a building. To the west sprawls the Western District, to the south the Hospital

Western District
Colourful and vibrant, the Western District is deprived in wealth but rich in culture. To the east lies the brick block of PringCorp bank.

You can see a cab (in which is a driver) here.

>get in cab
You climb into the cab. The driver says, "Where to sir?"

>go ED-13
"Sure!" The cab moves off. After a time, the cab pulls up at your destination. You pay the driver and get out.

Urban Sprawl
You are deep within the maze of urban life,. A sign nearby reads ED-13.

You can see a cab (in which is a driver) here.

>x cab
In the cab is a driver.

>look
Urban Sprawl
You are deep within the maze of urban life,. A sign nearby reads ED-13.

You can see a cab (in which is a driver) here.

>n
You can't go that way.

* * *

>s
You can't go that way.

>e
You can't go that way.

* * *

>n, n,
DingCorp Bank
An imposing corporate edifice. The Northern district sprawls to the north of here, while the Archives lie to the south.

Northern District
A vast maze of blocks stretching for miles, the Northern District is clean and green and houses the more affluent elements of the city. To the south is the impressive facde of DingCorp Bank.

You can see a cab (in which is a driver) here.

>enter cab
You climb into the cab. The driver says, "Where to sir?"

>go to ED-12
ED-12.
"Sure!" The cab moves off. After a time, the cab pulls up at your destination. You pay the driver and get out.

Urban Sprawl
You are deep within the maze of urban life,. A sign nearby reads ED-12.

You can see a cab (in which is a driver) here.

>enter cab
You climb into the cab. The driver says, "Where to sir?"

>go to city
city.
Sure! The cab returns to the centre of town. You pay the driver and get out.

Northern District
A vast maze of blocks stretching for miles, the Northern District is clean and green and houses the more affluent elements of the city. To the south is the impressive facde of DingCorp Bank.

You can see a cab (in which is a driver) here.

>s
DingCorp Bank
An imposing corporate edifice. The Northern district sprawls to the north of here, while the Archives lie to the south.

>s
Archives
A marble monument to knowledge. DingCorp Bank is to the north, the Hospital to the west, Silver Rush to the south and the Job Centre to the east.

>enter
You must supply a noun.

>enter Archives
You can't see any such thing.

* * *

This is the introduction text. Type "help" to see the game rules and instructions.

Gates
An Interactive Fiction by S R Williams
Release 1 / Serial number 191010 / Inform 7 build 6M62 (I6/v6.33 lib 6/12N) SD

Archives
A marble monument to knowledge. DingCorp Bank is to the north, the Hospital to the west, Silver Rush to the south and the Job Centre to the east.

You can see a research device here.

>search
1You have found Bob Jones!
2You have found Bill Speck!

* * *

>n, n
DingCorp Bank
An imposing corporate edifice. The Northern district sprawls to the north of here, while the Archives lie to the south.

Northern District
A vast maze of blocks stretching for miles, the Northern District is clean and green and houses the more affluent elements of the city. To the south is the impressive facde of DingCorp Bank.

You can see a cab (in which is a driver) here.

>enter cab
You climb into the cab. The driver says, "Where to sir?"

>go to ED-12
"Sure!" The cab moves off. After a time, the cab pulls up at your destination. You pay the driver and get out.

Urban Sprawl
You are deep within the maze of urban life,. A sign nearby reads ED-12.

You can see a cab (in which is a driver) here.

* * *

>enter cab
You climb into the cab. The driver says, "Where to sir?"

>go to "ND-12"
"Sorry, I don't know where that is."

>go to ND-12
"Sure!" The cab moves off. After a time, the cab pulls up at your destination. You pay the driver and get out.

Urban Sprawl
You are deep within the maze of urban life,. A sign nearby reads ND-12.

You can see a cab (in which is a driver) here.

>search
foo

* * *

This is the introduction text. Type "help" to see the game rules and instructions.

Gates
An Interactive Fiction by S R Williams
Release 1 / Serial number 191010 / Inform 7 build 6M62 (I6/v6.33 lib 6/12N) SD

Archives
A marble monument to knowledge. DingCorp Bank is to the north, the Hospital to the west, Silver Rush to the south and the Job Centre to the east.

You can see a research device here.

>x Bill
You can't see any such thing.

>n, n
DingCorp Bank
An imposing corporate edifice. The Northern district sprawls to the north of here, while the Archives lie to the south.

Northern District
A vast maze of blocks stretching for miles, the Northern District is clean and green and houses the more affluent elements of the city. To the south is the impressive facde of DingCorp Bank.

You can see a cab (in which is a driver) here.

* * *

>investigate
You thoroughly search the area. You have found Bill Speck!

>l
Urban Sprawl
You are deep within the maze of urban life,. A sign nearby reads SD-14.

You can see Bill Speck and a cab (in which is a driver) here.

>x Bill
You see nothing special about Bill Speck.

>ask bill about farts
There is no reply.

>punch Bill
Violence isn't the answer to this one.

* * *

>x Bill
You can't see any such thing.

>x Ben
You can't see any such thing.

>n, n
DingCorp Bank
An imposing corporate edifice. The Northern district sprawls to the north of here, while the Archives lie to the south.

Northern District
A vast maze of blocks stretching for miles, the Northern District is clean and green and houses the more affluent elements of the city. To the south is the impressive facde of DingCorp Bank.

You can see a cab (in which is a driver) here.

* * *

>x Bill
You see nothing special about Bill Speck.

>x Seck
You can't see any such thing.

>x Speck
You see nothing special about Bill Speck.

>x Bill Seck
I only understood you as far as wanting to examine Bill Speck.

>x Bill Speck
You see nothing special about Bill Speck.

>enter cab
You climb into the cab. The driver says, "Where to sir?"

>go to ND-12
"Sure!" The cab moves off. After a time, the cab pulls up at your destination. You pay the driver and get out.

Urban Sprawl
You are deep within the maze of urban life,. A sign nearby reads ND-12.

You can see Bill Speck and a cab (in which is a driver) here.

* * *

This is the introduction text. Type "help" to see the game rules and instructions.

Gates
An Interactive Fiction by S R Williams
Release 1 / Serial number 191010 / Inform 7 build 6M62 (I6/v6.33 lib 6/12N) SD

Archives
A marble monument to knowledge. DingCorp Bank is to the north, the Hospital to the west, Silver Rush to the south and the Job Centre to the east.

You can see a research device here.

>x research device
A desk covered in an array of brass tubules and an addressable spring-loaded typeboard for requesting information from the archive. The system you know is mostly pneumatic, but augmented with some crystal technology here and there. With a few presses you can summon printed information from anywhere in the Archive's stygian depths.

>use research device
You sit down and begin to check the records. Time passes as you fall into your task, the clacking of the typeboard and the whoosh of arriving papers sinking into your subconcious.

You sit back for a break. Nothing so far.

>use research device
You sit down and begin to check the records. Time passes as you fall into your task, the clacking of the typeboard and the whoosh of arriving papers sinking into your subconcious.

You sit back for a break. Nothing so far.

>use research device
You sit down and begin to check the records. Time passes as you fall into your task, the clacking of the typeboard and the whoosh of arriving papers sinking into your subconcious.

Hmm... this is interesting.

* * *

>use research device
You sit down and begin to check the records. Time passes as you fall into your task, the clacking of the typeboard and the whoosh of arriving papers sinking into your subconcious.

You sit back for a break. Nothing so far.

>e
Job Centre
A squat block, this place is the place where protifable business actions are transacted - for a fee, of course. The the west lies the Archives, to the north the Prospector's Guild, to the south the Training complex, and to the east a minor bank.

>n
Prospector's Guild
A somewhat ramshackle affair that belies the incredible wealth that the guild controls. In some sense, all of the city revolves around this place. To the south is the Job Cenre, while to the east is a minor bank.

>x guild
You can't see any such thing.

>i
You are carrying:
  an incursion scanner
  a notebook
  a map

>x incursion
A bulbous metal device, with apparently random wires sticking out of it and connecting to other parts. A copper billboard display, hundreds of tiny panels bearing letters and numbers, show the messages. A faint crystal luminesence glimmers in the gaps.

>use incursion
The display reads .

>x notebook
You check your notebook.

* * *

>s
Job Centre
A squat block, this place is the place where protifable business actions are transacted - for a fee, of course. The the west lies the Archives, to the north the Prospector's Guild, to the south the Training complex, and to the east a minor bank.

>e
Minor Bank 2
An unassuming brick co-operative. To the west is the Job Centre.

>e
You can't go that way.

>z
Time passes.

>z
Time passes.

The display of the incursion scanner updates. Its timer now shows 06:00 and its display reads Minor Bank 1.

>l
Minor Bank 2
An unassuming brick co-operative. To the west is the Job Centre.

* * *

>w,s,e
Job Centre
A squat block, this place is the place where protifable business actions are transacted - for a fee, of course. The the west lies the Archives, to the north the Prospector's Guild, to the south the Training complex, and to the east a minor bank.

Training
The foremost self-improvement place in the city, the simply-named Training has numerous instructors, courses and apparatues ready to test and extend your skills and knowledge - for a fee, of course. To the north lies the Job Centre, to the east a minor bank.

You can see an a desk (on which is a course book) here.

Minor Bank 4
A featureless concrete block, both inside and out. To the north is Training.

>w,s,e
Training
The foremost self-improvement place in the city, the simply-named Training has numerous instructors, courses and apparatues ready to test and extend your skills and knowledge - for a fee, of course. To the north lies the Job Centre, to the east a minor bank.

You can see an a desk (on which is a course book) here.

Your incursion scanner lets out a ringing chime. Its timer is 0, and its display reads Minor Bank 1. A red light comes on.

The red light on your scanner blinks out suddenly.

You can't go that way.

Minor Bank 4
A featureless concrete block, both inside and out. To the north is Training.

* * *

>x research device
A desk covered in an array of brass tubules and an addressable spring-loaded typeboard for requesting information from the archive. The system you know is mostly pneumatic, but augmented with some crystal technology here and there. With a few presses you can summon printed information from anywhere in the Archive's stygian depths.

>x scanner
A bulbous metal device, with apparently random wires sticking out of it and connecting to other parts. A copper billboard display, hundreds of tiny panels bearing letters and numbers, show the messages. A faint crystal luminesence glimmers in the gaps.

>x scanner
A bulbous metal device, with apparently random wires sticking out of it and connecting to other parts. A copper billboard display, hundreds of tiny panels bearing letters and numbers, show the messages. A faint crystal luminesence glimmers in the gaps.

>x scanner
A bulbous metal device, with apparently random wires sticking out of it and connecting to other parts. A copper billboard display, hundreds of tiny panels bearing letters and numbers, show the messages. A faint crystal luminesence glimmers in the gaps.

Your incursion scanner lets out a ringing chime. Its timer is 0, and its display reads BlingCorp Bank. A red light comes on.

>l
Archives
A marble monument to knowledge. DingCorp Bank is to the north, the Hospital to the west, Silver Rush to the south and the Job Centre to the east.

You can see a research device here.

* * *

>e,e,n
Job Centre
A squat block, this place is the place where protifable business actions are transacted - for a fee, of course. The the west lies the Archives, to the north the Prospector's Guild, to the south the Training complex, and to the east a minor bank.

Minor Bank 2
An unassuming brick co-operative. To the west is the Job Centre.

BlingCorp Bank
This baroque structure is bedecked with gold leaf and statues of various important persons in attitudes of important business, straddling the line between gaudy and magnificent. To the south is a much humbler minor bank, while to the east the Eastern District sprawls over the hills.

You can see a Gark here.

The red light on your scanner blinks out suddenly.
In front of your eyes, the monster seems to fold up and twist into a hole in space that does not seem to exist in normal 3d geometry. Suddenly, it's gone.
The display of the incursion scanner updates. Its timer now shows 03:00 and its display reads ZingCorp Bank.

>s,w,w,s,s
Minor Bank 2
An unassuming brick co-operative. To the west is the Job Centre.

Job Centre
A squat block, this place is the place where protifable business actions are transacted - for a fee, of course. The the west lies the Archives, to the north the Prospector's Guild, to the south the Training complex, and to the east a minor bank.

Archives
A marble monument to knowledge. DingCorp Bank is to the north, the Hospital to the west, Silver Rush to the south and the Job Centre to the east.

You can see a research device here.

Silver Rush
This unassuming place is not to be underestimated - it contains a huge collection of the latest gadgets and you can usually find a good deal. Burly guards lounge threateningly. To the north lies the sparkling marble of the Archives, to the south the spire of ZingCorp Bank.

Your incursion scanner lets out a ringing chime. Its timer is 0, and its display reads ZingCorp Bank. A red light comes on.

ZingCorp Bank
A twisting spire of some kind of black stone, this place is often referred to as the wizard's tower because of the affectations of the self-styled Grand Master Zing who runs it. To the north likes Silver Rush, to the south spreads the South District.

You can see a Gark here.

>x Gark
You see nothing special about the Gark.

>fight Gark
You fight the Gark!
the Gark has been defeated!

>x Gark
You can't see any such thing.

>l
ZingCorp Bank
A twisting spire of some kind of black stone, this place is often referred to as the wizard's tower because of the affectations of the self-styled Grand Master Zing who runs it. To the north likes Silver Rush, to the south spreads the South District.

>x map
The red light on your scanner blinks out suddenly.
The display of the incursion scanner updates. Its timer now shows 03:00 and its display reads BlingCorp Bank.

* * *

This is the introduction text. Type "help" to see the game rules and instructions.

Gates
An Interactive Fiction by S R Williams
Release 1 / Serial number 191010 / Inform 7 build 6M62 (I6/v6.33 lib 6/12N) SD

Archives
A marble monument to knowledge. DingCorp Bank is to the north, the Hospital to the west, Silver Rush to the south and the Job Centre to the east.

You can see a research device here.

>map
That's not a verb I recognise.

* * *

>w
Hospital
St. Clemens Hospital is a relatively modern construction. To the north lies PringCorp Bank, while a minor bank is to the south. The Archives lie east.

>e
Archives
A marble monument to knowledge. DingCorp Bank is to the north, the Hospital to the west, Silver Rush to the south and the Job Centre to the east.

You can see a research device here.

>e
Job Centre
A squat block, this place is the place where protifable business actions are transacted - for a fee, of course. The the west lies the Archives, to the north the Prospector's Guild, to the south the Training complex, and to the east a minor bank.

>s
Training
The foremost self-improvement place in the city, the simply-named Training has numerous instructors, courses and apparatues ready to test and extend your skills and knowledge - for a fee, of course. To the north lies the Job Centre, to the east a minor bank.

You can see a the desk (on which is a course book) here.

>x desk
On the the desk is a course book.

>x course book
You leaf through the course book, wincing slightly. Well, nobody said education was cheap.

>l
Training
The foremost self-improvement place in the city, the simply-named Training has numerous instructors, courses and apparatues ready to test and extend your skills and knowledge - for a fee, of course. To the north lies the Job Centre, to the east a minor bank.

You can see a the desk (on which is a course book) here.

>x course book
You leaf through the course book, wincing slightly. Well, nobody said education was cheap.

>read course book
You leaf through the course book, wincing slightly. Well, nobody said education was cheap.

* * *

>s, s
Silver Rush
This unassuming place is not to be underestimated - it contains a huge collection of the latest gadgets and you can usually find a good deal. Burly guards lounge threateningly. To the north lies the sparkling marble of the Archives, to the south the spire of ZingCorp Bank.

ZingCorp Bank
A twisting spire of some kind of black stone, this place is often referred to as the wizard's tower because of the affectations of the self-styled Grand Master Zing who runs it. To the north likes Silver Rush, to the south spreads the South District.

You can see a monsterOne here.

>fight monsterOne
You fight the monsterOne!

>battle monsterOne
You fight the monsterOne!

* * *

This is the introduction text. Type "help" to see the game rules and instructions.

Gates
An Interactive Fiction by S R Williams
Release 1 / Serial number 191010 / Inform 7 build 6M62 (I6/v6.33 lib 6/12N) SD

Archives
A marble monument to knowledge. DingCorp Bank is to the north, the Hospital to the west, Silver Rush to the south and the Job Centre to the east.

You can see a research device here.

>confront me
You angrily berate yourself, but it doesn't make any difference.

>n, n
DingCorp Bank
An imposing corporate edifice. The Northern district sprawls to the north of here, while the Archives lie to the south.

Northern District
A vast maze of blocks stretching for miles, the Northern District is clean and green and houses the more affluent elements of the city. To the south is the impressive facde of DingCorp Bank.

You can see a cab (in which is a driver) here.

* * *

>enter cab
You climb into the cab. The driver says, "Where to?"

>go to WD-80
"Sure!" The cab moves off. After a time, the cab pulls up at your destination. You pay the driver and get out.

Urban Sprawl
You are deep within the maze of urban life,. A sign nearby reads WD-80.

You can see a cab (in which is a driver) here.

>investigate
You thoroughly search the area. You have found Jim Juke!

>confront Jim
You persuade Jim!

>enter cab
You climb into the cab. The driver says, "Where to?"

* * *

>investigate
You thoroughly search the area. You have found Belinda Speck!

>confront Belinda
You persuade Belinda!

* * *

This is the introduction text. Type "help" to see the game rules and instructions.

Gates
An Interactive Fiction by S R Williams
Release 1 / Serial number 191010 / Inform 7 build 6M62 (I6/v6.33 lib 6/12N) SD

Archives
A marble monument to knowledge. DingCorp Bank is to the north, the Hospital to the west, Silver Rush to the south and the Job Centre to the east.

You can see a research device here.

>x research
A desk covered in an array of brass tubules and an addressable spring-loaded typeboard for requesting information from the archive. The system you know is mostly pneumatic, but augmented with some crystal technology here and there. With a few presses you can summon printed information from anywhere in the Archive's stygian depths.

>n, n
DingCorp Bank
An imposing corporate edifice. The Northern district sprawls to the north of here, while the Archives lie to the south.

Northern District
A vast maze of blocks stretching for miles, the Northern District is clean and green and houses the more affluent elements of the city. To the south is the impressive facde of DingCorp Bank.

You can see a cab (in which is a driver) here.

* * *

>search
You thoroughly search the area. You have found Belinda Speck!

>confront Belinda
You fight Belinda!

>enter cab
You climb into the cab. The driver says, "Where to?"

* * *

>search
You thoroughly search the area. You have found Jim Juke!

>confront Jim Juke
You persuade Jim!

* * *

>x research
A desk covered in an array of brass tubules and an addressable spring-loaded typeboard for requesting information from the archive. The system you know is mostly pneumatic, but augmented with some crystal technology here and there. With a few presses you can summon printed information from anywhere in the Archive's stygian depths.

>research
That's not a verb I recognise.

>study
That's not a verb I recognise.

>use research
You sit down and begin to check the records. Time passes as you fall into your task, the clacking of the typeboard and the whoosh of arriving papers sinking into your subconcious.

You sit back for a break. Nothing so far.

>n
DingCorp Bank
An imposing corporate edifice. The Northern district sprawls to the north of here, while the Archives lie to the south.

* * *

>n
Northern District
A vast maze of blocks stretching for miles, the Northern District is clean and green and houses the more affluent elements of the city. To the south is the impressive facde of DingCorp Bank.

You can see a cab (in which is a driver) here.

>get into cab
You climb into the cab. The driver says, "Where to?"

>go to ED-67
"Sure!" The cab moves off. After a time, the cab pulls up at your destination. You pay the driver and get out.

Urban Sprawl
You are deep within the maze of urban life,. A sign nearby reads ED-67.

You can see a cab (in which is a driver) here.

* * *

>search
You thoroughly search the area. You have found Emily Yang!

>confront emily
Emily is happy to talk to you.
"Bob Jones has family that lives in the North District, between block 10 and 15 I think".

>enter cab
You climb into the cab. The driver says, "Where to?"

>go to ND-10
"Sure!" The cab moves off. After a time, the cab pulls up at your destination. You pay the driver and get out.

Urban Sprawl
You are deep within the maze of urban life,. A sign nearby reads ND-10.

You can see a cab (in which is a driver) here.

>search
You thoroughly search the area, but come up empy handed.

>get into cab
You climb into the cab. The driver says, "Where to?"

>go to ND-11
"Sure!" The cab moves off. After a time, the cab pulls up at your destination. You pay the driver and get out.

Urban Sprawl
You are deep within the maze of urban life,. A sign nearby reads ND-11.

You can see a cab (in which is a driver) here.

>search
You thoroughly search the area, but come up empy handed.

* * *

>search
You thoroughly search the area. You have found Bob Jones!

>confront Bob
You persuade Bob!
"OK, I guess... I know the code fragment A1 is at position 10".

>thanks
That's not a verb I recognise.

>get into cab
You climb into the cab. The driver says, "Where to?"

>l
Urban Sprawl (in the cab)
You are deep within the maze of urban life,. A sign nearby reads ND-12.

You can see Bob Jones here.

In the cab you can see a driver.

>go to WD-80
"Sure!" The cab moves off. After a time, the cab pulls up at your destination. You pay the driver and get out.

Urban Sprawl
You are deep within the maze of urban life,. A sign nearby reads WD-80.

You can see a cab (in which is a driver) here.

* * *

>search
You thoroughly search the area. You have found Jim Juke!

>confront Jim Juke
You fail to persuade Jim. They walk away, looking agitated.

>search
You thoroughly search the area. You have found Jim Juke!

>search
You thoroughly search the area. You have found Jim Juke!

>confront
(Jim Juke)
You fail to persuade Jim. They walk away, looking agitated.

>search
You thoroughly search the area. You have found Jim Juke!

* * *

>confront
(Jim Juke)
You fail to persuade Jim. They walk away, looking agitated.

>saerch
That's not a verb I recognise.

>search
You thoroughly search the area. You have found Jim Juke!

>confront
(Jim Juke)
You persuade Jim!
"OK, I guess... Last I knew, Belinda Speck was hiding in SD-14".

>get into cab
You climb into the cab. The driver says, "Where to?"

* * *

>confront
(Belinda Speck)
You are beaten up by Belinda. They get away!

>confront
(the driver)
Belinda is happy to talk to you.
"I know the code fragment D6 is at position 4".

* * *

>e,e,n
Job Centre
A squat block, this place is the place where protifable business actions are transacted - for a fee, of course. The the west lies the Archives, to the north the Prospector's Guild, to the south the Training complex, and to the east a minor bank.

Minor Bank 2
An unassuming brick co-operative. To the west is the Job Centre.

BlingCorp Bank
This baroque structure is bedecked with gold leaf and statues of various important persons in attitudes of important business, straddling the line between gaudy and magnificent. To the south is a much humbler minor bank, while to the east the Eastern District sprawls over the hills.

Your incursion scanner lets out a ringing chime. Its timer is 0, and its display reads BlingCorp Bank. A red light comes on.

>l
BlingCorp Bank
This baroque structure is bedecked with gold leaf and statues of various important persons in attitudes of important business, straddling the line between gaudy and magnificent. To the south is a much humbler minor bank, while to the east the Eastern District sprawls over the hills.

You can see a Gark here.

Gark attacks!

>attack commander gark
You can't see any such thing.

* * *

>l
BlingCorp Bank
This baroque structure is bedecked with gold leaf and statues of various important persons in attitudes of important business, straddling the line between gaudy and magnificent. To the south is a much humbler minor bank, while to the east the Eastern District sprawls over the hills.

You can see a Gark here.

Gark attacks!

>fight Gark
You fight the Gark!
the Gark has been defeated!

The red light on your scanner blinks out suddenly.
The display of the incursion scanner updates. Its timer now shows 03:00 and its display reads Minor Bank 1.

>l
BlingCorp Bank
This baroque structure is bedecked with gold leaf and statues of various important persons in attitudes of important business, straddling the line between gaudy and magnificent. To the south is a much humbler minor bank, while to the east the Eastern District sprawls over the hills.

>x scanner
A bulbous metal device, with apparently random wires sticking out of it and connecting to other parts. A copper billboard display, hundreds of tiny panels bearing letters and numbers, show the messages. A faint crystal luminesence glimmers in the gaps.

>use scanner
The display reads Minor Bank 1.

Your incursion scanner lets out a ringing chime. Its timer is 0, and its display reads Minor Bank 1. A red light comes on.

* * *

>z
Time passes.

>l
BlingCorp Bank
This baroque structure is bedecked with gold leaf and statues of various important persons in attitudes of important business, straddling the line between gaudy and magnificent. To the south is a much humbler minor bank, while to the east the Eastern District sprawls over the hills.

You can see a Commander Gark here.

>fight gark
You can't see any such thing.

>fight commander gark
You fight the group of 2 Commander Garks!
You fail to harm the group of 2 Commander Garks.

The group of 2 Commander Garks attacks!
You shrug off the blow.

>fight commander gark
You fight the group of 2 Commander Garks!
You fail to harm the group of 2 Commander Garks.

The group of 2 Commander Garks attacks!
You are wounded!

>fight commander gark
You fight the group of 2 Commander Garks!
You fail to harm the group of 2 Commander Garks.

The group of 2 Commander Garks attacks!
You are wounded!

>fight commander gark
You fight the group of 2 Commander Garks!
You hit!

The group of 2 Commander Garks attacks!
You are wounded!

>fight commander gark
You fight the group of 2 Commander Garks!
You hit!

The group of 2 Commander Garks attacks!
You are wounded!

>fight commander gark
You fight the group of 2 Commander Garks!
You hit!
One of the group of 2 Commander Garks falls, leaving 1!

The Commander Gark attacks!
You are wounded!

>fight commander gark
You fight the Commander Gark!
You fail to harm the Commander Gark.

The Commander Gark attacks!
You are wounded!

>fight commander gark
You fight the Commander Gark!
You hit!

The Commander Gark attacks!
You are wounded!

>fight commander gark
You fight the Commander Gark!
You hit!

The Commander Gark attacks!
You are wounded!

>fight commander gark
You fight the Commander Gark!
You hit!
One of the Commander Gark falls, leaving 0!

The Commander Gark attacks!
You are wounded!

Clucking wildly, the monsters retreat in disarray. With an eye-wrenching twist in space, they fold up into nothing and vanish.
The red light on your scanner blinks out suddenly.
The display of the incursion scanner updates. Its timer now shows 03:00 and its display reads BlingCorp Bank.

* * *

>s
Silver Rush
This unassuming place is not to be underestimated - it contains a huge collection of the latest gadgets and you can usually find a good deal. Burly guards lounge threateningly. To the north lies the sparkling marble of the Archives, to the south the spire of ZingCorp Bank.

You can see a catalogue here.

>x catalogue
You flick through the catalogue. The following items catch your eye:Shotgun - $15 and Derringer - $4

* * *

>n, e, e, n
DingCorp Bank
An imposing corporate edifice. The Northern district sprawls to the north of here, while the Archives lie to the south.

You can't go that way.

You can't go that way.

Your incursion scanner lets out a ringing chime. Its timer is 0, and its display reads BlingCorp Bank. A red light comes on.

Northern District
A vast maze of blocks stretching for miles, the Northern District is clean and green and houses the more affluent elements of the city. To the south is the impressive facde of DingCorp Bank.

You can see a cab (in which is a driver) here.

>s, e, e, n
DingCorp Bank
An imposing corporate edifice. The Northern district sprawls to the north of here, while the Archives lie to the south.

You can't go that way.

You can't go that way.

Northern District
A vast maze of blocks stretching for miles, the Northern District is clean and green and houses the more affluent elements of the city. To the south is the impressive facde of DingCorp Bank.

You can see a cab (in which is a driver) here.

>l
Northern District
A vast maze of blocks stretching for miles, the Northern District is clean and green and houses the more affluent elements of the city. To the south is the impressive facde of DingCorp Bank.

You can see a cab (in which is a driver) here.

* * *

>s
DingCorp Bank
An imposing corporate edifice. The Northern district sprawls to the north of here, while the Archives lie to the south.

* * *

>s
Archives
A marble monument to knowledge. DingCorp Bank is to the north, the Hospital to the west, Silver Rush to the south and the Job Centre to the east.

You can see a research device here.

>e, e, n
Job Centre
A squat block, this place is the place where protifable business actions are transacted - for a fee, of course. The the west lies the Archives, to the north the Prospector's Guild, to the south the Training complex, and to the east a minor bank.

Minor Bank 2
An unassuming brick co-operative. To the west is the Job Centre.

BlingCorp Bank
This baroque structure is bedecked with gold leaf and statues of various important persons in attitudes of important business, straddling the line between gaudy and magnificent. To the south is a much humbler minor bank, while to the east the Eastern District sprawls over the hills.

You can see a group of 5 Garks here.

>fight gark
You fight the group of 5 Garks!
The group of 5 Garks shrugs off the attack!

The group of 5 Garks attacks!
You shrug off the blow.

>fight gark
You fight the group of 5 Garks!
The group of 5 Garks shrugs off the attack!

The group of 5 Garks attacks!
You are wounded!

>fight gark
You fight the group of 5 Garks!
You hit!

The group of 5 Garks attacks!
You shrug off the blow.

>fight gark
You fight the group of 5 Garks!
You hit!
One of the group of 5 Garks falls, leaving 4!

The group of 4 Garks attacks!
You shrug off the blow.

>fight garl
You can't see any such thing.

>fight gark
You fight the group of 4 Garks!
The group of 4 Garks shrugs off the attack!

The group of 4 Garks attacks!
You are wounded!

>fight gark
You fight the group of 4 Garks!
You hit!

The group of 4 Garks attacks!
You shrug off the blow.

>fight gark
You fight the group of 4 Garks!
You hit!
One of the group of 4 Garks falls, leaving 3!

The group of 3 Garks attacks!
You shrug off the blow.

>fight gark
You fight the group of 3 Garks!
You hit!

The group of 3 Garks attacks!
You shrug off the blow.

>fight gark
You fight the group of 3 Garks!
You hit!
One of the group of 3 Garks falls, leaving 2!

The group of 2 Garks attacks!
You are wounded!

The red light on your scanner blinks out suddenly.
The monsters shove past you into the vault. Hooting triumphantly, they stuff their sacks full of crystals and, with an eye-wrenching twist in space, fold up into nothing and vanish.
The display of the incursion scanner updates. Its timer now shows 03:00 and its display reads DingCorp Bank.

>x me
As good-looking as ever.

* * *

>e, n
Job Centre
A squat block, this place is the place where protifable business actions are transacted - for a fee, of course. The the west lies the Archives, to the north the Prospector's Guild, to the south the Training complex, and to the east a minor bank.

Prospector's Guild
A somewhat ramshackle affair that belies the incredible wealth that the guild controls. In some sense, all of the city revolves around this place. To the south is the Job Cenre, while to the east is a minor bank.

On the wall a battered sign exclaims "Exchange crystals for ready cash! Great rates available!"

You can also see a teller here.

>x teller
She looks at you appraisingly through her monocle.

>ask teller about rates
You can only do that to something animate.

* * *

>w
Hospital
St. Clemens Hospital is a relatively modern construction. To the north lies PringCorp Bank, while a minor bank is to the south. The Archives lie east.

You can see a doctor here.

>x doctor
You see nothing special about the doctor.

>talk to doctor
You don't need to see a doctor.

* * *

This is the introduction text. Type "help" to see the game rules and instructions.

Gates
An Interactive Fiction by S R Williams
Release 1 / Serial number 191010 / Inform 7 build 6M62 (I6/v6.33 lib 6/12N) SD

Archives
A marble monument to knowledge. DingCorp Bank is to the north, the Hospital to the west, Silver Rush to the south and the Job Centre to the east.

You can see a research device here.

>s, s
Silver Rush
This unassuming place is not to be underestimated - it contains a huge collection of the latest gadgets and you can usually find a good deal. Burly guards lounge threateningly. To the north lies the sparkling marble of the Archives, to the south the spire of ZingCorp Bank.

You can see a counter (on which are a derringer, a shotgun and a magnifying glass) and an attendant here.

ZingCorp Bank
A twisting spire of some kind of black stone, this place is often referred to as the wizard's tower because of the affectations of the self-styled Grand Master Zing who runs it. To the north likes Silver Rush, to the south spreads the South District.

>fight monsterOne
You fight the monsterOne!

>attack monsterOne
You fight the monsterOne!

>hit monsterOne
You fight the monsterOne!

>battle monsterOne
You fight the monsterOne!

>kick monsterOne
That's not a verb I recognise.

>punch monsterone
You fight the monsterOne!
the monsterOne has been defeated!

>l
ZingCorp Bank
A twisting spire of some kind of black stone, this place is often referred to as the wizard's tower because of the affectations of the self-styled Grand Master Zing who runs it. To the north likes Silver Rush, to the south spreads the South District.

* * *

>fight monster
You can't see any such thing.

>fight monsterOne
You fight the monsterOne!

The monster attacks!

* * *

>battle monster
You can't see any such thing.

>battle monsterOne
You fight the monsterOne!

The monster attacks!

>battle monsterOne
You fight the monsterOne!

The monster attacks!
You have died!

    *** The End ***

Would you like to RESTART, RESTORE a saved game, QUIT or UNDO the last command?

* * *

>attack monsterOne
You fight the monsterOne!

The monster attacks!

>attack monsterOne
You fight the monsterOne!

The monster attacks!

    *** You have died ***

Would you like to RESTART, RESTORE a saved game, QUIT or UNDO the last command?

* * *

>battle monsterone
You fight the monsterOne!

monsterOne attacks!
monsterTwo attacks!

>battle monsterone
You fight the monsterOne!

monsterOne attacks!
monsterTwo attacks!

>battle monsteron
You fight the monsterOne!

monsterOne attacks!
monsterTwo attacks!

>battle monsterone
You fight the monsterOne!

monsterOne attacks!
monsterTwo attacks!

    *** You have died ***

Would you like to RESTART, RESTORE a saved game, QUIT or UNDO the last command?

* * *

>z
Time passes.

>z
Time passes.

Your incursion scanner lets out a ringing chime. Its timer is 0, and its display reads BlingCorp Bank. A red light comes on.

>x ma
You can't see any such thing.

* * *

>n,n,e,e,n
Silver Rush
This unassuming place is not to be underestimated - it contains a huge collection of the latest gadgets and you can usually find a good deal. Burly guards lounge threateningly. To the north lies the sparkling marble of the Archives, to the south the spire of ZingCorp Bank.

You can see a counter (on which are a derringer, a shotgun and a magnifying glass) and an attendant here.

Archives
A marble monument to knowledge. DingCorp Bank is to the north, the Hospital to the west, Silver Rush to the south and the Job Centre to the east.

You can see a research device here.

Job Centre
A squat block, this place is the place where protifable business actions are transacted - for a fee, of course. The the west lies the Archives, to the north the Prospector's Guild, to the south the Training complex, and to the east a minor bank.

Minor Bank 2
An unassuming brick co-operative. To the west is the Job Centre.

BlingCorp Bank
This baroque structure is bedecked with gold leaf and statues of various important persons in attitudes of important business, straddling the line between gaudy and magnificent. To the south is a much humbler minor bank, while to the east the Eastern District sprawls over the hills.

You can see a 2 Garks here.

>x gark
You see nothing special about the 2 Garks.

>x gar
You can't see any such thing.

>fight garks
You can't see any such thing.

>fight gark
You fight the 2 Garks!
The 2 Garks is wounded!

The 2 Garks attacks!
You shrug off the blow.

* * *

This is the introduction text. Type "help" to see the game rules and instructions.

Gates
An Interactive Fiction by S R Williams
Release 1 / Serial number 191010 / Inform 7 build 6M62 (I6/v6.33 lib 6/12N) SD

Archives
A marble monument to knowledge. DingCorp Bank is to the north, the Hospital to the west, Silver Rush to the south and the Job Centre to the east.

You can see a research device here.

>ma
That's not a verb I recognise.

* * *

>s, s
Silver Rush
This unassuming place is not to be underestimated - it contains a huge collection of the latest gadgets and you can usually find a good deal. Burly guards lounge threateningly. To the north lies the sparkling marble of the Archives, to the south the spire of ZingCorp Bank.

ZingCorp Bank
A twisting spire of some kind of black stone, this place is often referred to as the wizard's tower because of the affectations of the self-styled Grand Master Zing who runs it. To the north likes Silver Rush, to the south spreads the South District.

You can see a monsterTwo and a monsterOne here.

The monster attacks!

>fight
What do you want to fight?

>fight monster
You can't see any such thing.

>fight monsterone
You fight the monsterOne!

The monster attacks!

>fight monstertwo
You fight the monsterTwo!
the monsterTwo has been defeated!

The monster attacks!

    *** You have died ***

Would you like to RESTART, RESTORE a saved game, QUIT or UNDO the last command?

* * *

This is the introduction text. Type "help" to see the game rules and instructions.

Gates
An Interactive Fiction by S R Williams
Release 1 / Serial number 191010 / Inform 7 build 6M62 (I6/v6.33 lib 6/12N) SD

Archives
A marble monument to knowledge. DingCorp Bank is to the north, the Hospital to the west, Silver Rush to the south and the Job Centre to the east.

You can see a research device here.

>use incursion
The display reads BlingCorp. The timer is currently 20.

>n
DingCorp Bank
An imposing corporate edifice. The Northern district sprawls to the north of here, while the Archives lie to the south.

>l
DingCorp Bank
An imposing corporate edifice. The Northern district sprawls to the north of here, while the Archives lie to the south.

>use incursion
The display reads BlingCorp. The timer is currently 17.

>use incursion
The display reads BlingCorp. The timer is currently 16.

>wairt
That's not a verb I recognise.

>wait
Time passes.

>w
You can't go that way.

>wait
Time passes.

>map
That's not a verb I recognise.

>l
DingCorp Bank
An imposing corporate edifice. The Northern district sprawls to the north of here, while the Archives lie to the south.

>x ma
You can't see any such thing.

* * *

>s, e, e, n
Archives
A marble monument to knowledge. DingCorp Bank is to the north, the Hospital to the west, Silver Rush to the south and the Job Centre to the east.

You can see a research device here.

Job Centre
A squat block, this place is the place where protifable business actions are transacted - for a fee, of course. The the west lies the Archives, to the north the Prospector's Guild, to the south the Training complex, and to the east a minor bank.

Minor Bank 2
An unassuming brick co-operative. To the west is the Job Centre.

You can't go that way.

>n
You can't go that way.

* * *

This is the introduction text. Type "help" to see the game rules and instructions.

Gates
An Interactive Fiction by S R Williams
Release 1 / Serial number 191010 / Inform 7 build 6M62 (I6/v6.33 lib 6/12N) SD

Archives
A marble monument to knowledge. DingCorp Bank is to the north, the Hospital to the west, Silver Rush to the south and the Job Centre to the east.

You can see a research device here.

>e, e, n
Job Centre
A squat block, this place is the place where protifable business actions are transacted - for a fee, of course. The the west lies the Archives, to the north the Prospector's Guild, to the south the Training complex, and to the east a minor bank.

Minor Bank 2
An unassuming brick co-operative. To the west is the Job Centre.

BlingCorp Bank
This baroque structure is bedecked with gold leaf and statues of various important persons in attitudes of important business, straddling the line between gaudy and magnificent. To the south is a much humbler minor bank, while to the east the Eastern District sprawls over the hills.

>l
BlingCorp Bank
This baroque structure is bedecked with gold leaf and statues of various important persons in attitudes of important business, straddling the line between gaudy and magnificent. To the south is a much humbler minor bank, while to the east the Eastern District sprawls over the hills.

>wait
Time passes.

>wait
Time passes.

>use scanner
The display reads BlingCorp. The timer is currently 12.

>e
Eastern District
Winding sinuously up into the hills that formerly were outside the town, the eastern district is largely middle class, and has absorbed several older villages. To the east is the grand BlingCorp Bank.

You can see a cab (in which is a driver) here.

>e
You can't go that way.

>w
BlingCorp Bank
This baroque structure is bedecked with gold leaf and statues of various important persons in attitudes of important business, straddling the line between gaudy and magnificent. To the south is a much humbler minor bank, while to the east the Eastern District sprawls over the hills.

>z
Time passes.

>x scanner
A bulbous metal device, with apparently random wires sticking out of it and connecting to other parts. A copper billboard display, hundreds of tiny panels bearing letters and numbers, show the messages. A faint crystal luminesence glimmers in the gaps.

>use scanner
The display reads BlingCorp. The timer is currently 1.

>z
Time passes.

Your incursion scanner lets out a ringing chime. Its timer is 0, and its display reads BlingCorp.

>l
BlingCorp Bank
This baroque structure is bedecked with gold leaf and statues of various important persons in attitudes of important business, straddling the line between gaudy and magnificent. To the south is a much humbler minor bank, while to the east the Eastern District sprawls over the hills.

* * *

>z
Time passes.

Your incursion scanner lets out a ringing chime. Its timer is 0, and its display reads BlingCorp Bank. A red light comes on.

With a strange wrenching motion, things appear to unfold from thin air! They drop to the ground, gargling, and rush towards the vault.

>l
BlingCorp Bank
This baroque structure is bedecked with gold leaf and statues of various important persons in attitudes of important business, straddling the line between gaudy and magnificent. To the south is a much humbler minor bank, while to the east the Eastern District sprawls over the hills.

You can see a Commander Gark here.

>fight Gark
You fight the Gark!
The Gark has been defeated!

The red light on your scanner blinks out suddenly.
The display of the incursion scanner updates. Its timer now shows 03:00 and its display reads Minor Bank 4.

>x
What do you want to examine?

* * *

>s,w,w,w,s
Minor Bank 2
An unassuming brick co-operative. To the west is the Job Centre.

Job Centre
A squat block, this place is the place where protifable business actions are transacted - for a fee, of course. The the west lies the Archives, to the north the Prospector's Guild, to the south the Training complex, and to the east a minor bank.

Your incursion scanner lets out a ringing chime. Its timer is 0, and its display reads Minor Bank 4. A red light comes on.

Archives
A marble monument to knowledge. DingCorp Bank is to the north, the Hospital to the west, Silver Rush to the south and the Job Centre to the east.

You can see a research device here.

Hospital
St. Clemens Hospital is a relatively modern construction. To the north lies PringCorp Bank, while a minor bank is to the south. The Archives lie east.

Minor Bank 1
A drab and beaurocratic affair, with a sign that reads "Clemens and Co.". To the north lies the Hospital.

>z
Time passes.

>z
Time passes.

The red light on your scanner blinks out suddenly.
The display of the incursion scanner updates. Its timer now shows 03:00 and its display reads Minor Bank 1.

>l
Minor Bank 1
A drab and beaurocratic affair, with a sign that reads "Clemens and Co.". To the north lies the Hospital.

>z
Time passes.

>z
Time passes.

Your incursion scanner lets out a ringing chime. Its timer is 0, and its display reads Minor Bank 1. A red light comes on.

>l
Minor Bank 1
A drab and beaurocratic affair, with a sign that reads "Clemens and Co.". To the north lies the Hospital.

You can see a Commander Gark here.

>fight commander
You can't see any such thing.

>fight commander gark
You fight the Commander Gark!

The Commander Gark attacks!

>fight commander gark
You fight the Commander Gark!

The Commander Gark attacks!

>fight commander gark
You fight the Commander Gark!
The Commander Gark has been defeated!

The red light on your scanner blinks out suddenly.
The display of the incursion scanner updates. Its timer now shows 03:00 and its display reads Minor Bank 2.

* * *

>l
BlingCorp Bank
This baroque structure is bedecked with gold leaf and statues of various important persons in attitudes of important business, straddling the line between gaudy and magnificent. To the south is a much humbler minor bank, while to the east the Eastern District sprawls over the hills.

You can see a Commander Gark here.

>fight commander
You can't see any such thing.

>fight commander gark
You fight the group of 3 Commander Garks!
You hit!

The group of 3 Commander Garks attacks!
You shrug off the blow.

>fight commander gark
You fight the group of 3 Commander Garks!
You hit!

The group of 3 Commander Garks attacks!
You are wounded!

>s
Minor Bank 2
An unassuming brick co-operative. To the west is the Job Centre.

The red light on your scanner blinks out suddenly.
The display of the incursion scanner updates. Its timer now shows 03:00 and its display reads Minor Bank 2.

* * *

>s
Minor Bank 2
An unassuming brick co-operative. To the west is the Job Centre.

Your incursion scanner lets out a ringing chime. Its timer is 0, and its display reads BlingCorp Bank. A red light comes on.

The red light on your scanner blinks out suddenly.
The display of the incursion scanner updates. Its timer now shows 03:00 and its display reads DingCorp Bank.

>z
Time passes.

>z
Time passes.

Your incursion scanner lets out a ringing chime. Its timer is 0, and its display reads DingCorp Bank. A red light comes on.

    *** The enemy has stolen all of the crystals! ***

Would you like to RESTART, RESTORE a saved game, QUIT or UNDO the last command?

* * *

This is the introduction text. Type "help" to see the game rules and instructions.

Gates
An Interactive Fiction by S R Williams
Release 1 / Serial number 191010 / Inform 7 build 6M62 (I6/v6.33 lib 6/12N) SD

Archives
A marble monument to knowledge. DingCorp Bank is to the north, the Hospital to the west, Silver Rush to the south and the Job Centre to the east.

You can see a research device here.

>s
Silver Rush
This unassuming place is not to be underestimated - it contains a huge collection of the latest gadgets and you can usually find a good deal. Burly guards lounge threateningly. To the north lies the sparkling marble of the Archives, to the south the spire of ZingCorp Bank.

You can see a counter (on which are a derringer, a shotgun and a magnifying glass) and an attendant here.

>s
ZingCorp Bank
A twisting spire of some kind of black stone, this place is often referred to as the wizard's tower because of the affectations of the self-styled Grand Master Zing who runs it. To the north likes Silver Rush, to the south spreads the South District.

>n
Silver Rush
This unassuming place is not to be underestimated - it contains a huge collection of the latest gadgets and you can usually find a good deal. Burly guards lounge threateningly. To the north lies the sparkling marble of the Archives, to the south the spire of ZingCorp Bank.

>n
Archives
A marble monument to knowledge. DingCorp Bank is to the north, the Hospital to the west, Silver Rush to the south and the Job Centre to the east.

You can see a research device here.

>x scanner
A bulbous metal device, with apparently random wires sticking out of it and connecting to other parts. A copper billboard display, hundreds of tiny panels bearing letters and numbers, show the messages. A faint crystal luminesence glimmers in the gaps.

>use scanner
The display reads BlingCorp Bank. The timer is currently 0.

Your incursion scanner lets out a ringing chime. Its timer is 0, and its display reads BlingCorp Bank.
The display of the incursion scanner updates. Its timer is now 5 and its display reads Minor Bank 2.

* * *

>e, e, n
Job Centre
A squat block, this place is the place where protifable business actions are transacted - for a fee, of course. The the west lies the Archives, to the north the Prospector's Guild, to the south the Training complex, and to the east a minor bank.

Minor Bank 2
An unassuming brick co-operative. To the west is the Job Centre.

BlingCorp Bank
This baroque structure is bedecked with gold leaf and statues of various important persons in attitudes of important business, straddling the line between gaudy and magnificent. To the south is a much humbler minor bank, while to the east the Eastern District sprawls over the hills.

You can see a monsterOne here.

monsterOne attacks!

>attack monsterOne
You fight the monsterOne!

monsterOne attacks!

>fight monsterOne
You fight the monsterOne!

monsterOne attacks!

Your incursion scanner lets out a ringing chime. Its timer is 0, and its display reads Minor Bank 2.
The display of the incursion scanner updates. Its timer is now 5 and its display reads Minor Bank 4.

>fight monsterOne
You fight the monsterOne!

monsterOne attacks!

>fight monsterOne
You fight the monsterOne!

monsterOne attacks!

>fight monsterOne
You fight the monsterOne!
the monsterOne has been defeated!

>l
BlingCorp Bank
This baroque structure is bedecked with gold leaf and statues of various important persons in attitudes of important business, straddling the line between gaudy and magnificent. To the south is a much humbler minor bank, while to the east the Eastern District sprawls over the hills.

Your incursion scanner lets out a ringing chime. Its timer is 0, and its display reads Minor Bank 4.
The display of the incursion scanner updates. Its timer is now 5 and its display reads Minor Bank 1.

>map
That's not a verb I recognise.

* * *

>quit
Are you sure you want to quit?

* * *

>s
Silver Rush
This unassuming place is not to be underestimated - it contains a huge collection of the latest gadgets and you can usually find a good deal. Burly guards lounge threateningly. To the north lies the sparkling marble of the Archives, to the south the spire of ZingCorp Bank.

You can see a counter (on which are a derringer, a shotgun and a magnifying glass) and an attendant here.

>x catalogue
You flick through the catalogue. The following items catch your eye:
Shotgun ($15) and Derringer ($4).

>buy Shotgun
You can't see any such thing.

>buy
What do you want to buy?

>buy fart
You can't see any such thing.

* * *

>s
Silver Rush
This unassuming place is not to be underestimated - it contains a huge collection of the latest gadgets and you can usually find a good deal. Burly guards lounge threateningly. To the north lies the sparkling marble of the Archives, to the south the spire of ZingCorp Bank.

You can see a counter (on which are a derringer, a shotgun and a magnifying glass) and an attendant here.

>x guard
The guards look large, and burly, and bored - a dangerous combination.

>x shotgun
You see nothing special about the shotgun.

>get shotgun
Your incursion scanner lets out a ringing chime. Its timer is 0, and its display reads BlingCorp Bank. A red light comes on.

>n
A burly guard nonchalantly moves to block your exit. "You gonna pay for that or what?"

* * *

>s
Silver Rush
This unassuming place is not to be underestimated - it contains a huge collection of the latest gadgets and you can usually find a good deal. Burly guards lounge threateningly. To the north lies the sparkling marble of the Archives, to the south the spire of ZingCorp Bank.

You can see a counter (on which are a derringer, a shotgun and a magnifying glass) and an attendant here.

>n
Archives
A marble monument to knowledge. DingCorp Bank is to the north, the Hospital to the west, Silver Rush to the south and the Job Centre to the east.

You can see a research device here.

>s
Silver Rush
This unassuming place is not to be underestimated - it contains a huge collection of the latest gadgets and you can usually find a good deal. Burly guards lounge threateningly. To the north lies the sparkling marble of the Archives, to the south the spire of ZingCorp Bank.

You can see a counter (on which are a shotgun, a derringer and an orb of transmutation) and an attendant here.

>get shotgun
Your incursion scanner lets out a ringing chime. Its timer is 0, and its display reads BlingCorp Bank. A red light comes on.

* * *

>n
A burly guard nonchalantly moves to block your exit. "You gonna pay for that or what?"

>drop shotgun
You don't think they'd take lightly to littering here.

>put shotgun on counter
You put the shotgun on the counter.

>s
A burly guard nonchalantly moves to block your exit. "You gonna pay for that or what?"

* * *

>s
Silver Rush
This unassuming place is not to be underestimated - it contains a huge collection of the latest gadgets and you can usually find a good deal. Burly guards lounge threateningly. To the north lies the sparkling marble of the Archives, to the south the spire of ZingCorp Bank.

You can see a counter (on which are a derringer, a shotgun and a magnifying glass) and an attendant here.

>x shotgun
You see nothing special about the shotgun.

>get shotgun
Taken.

>s
A burly guard nonchalantly moves to block your exit. "You gonna pay for that or what?"

Your incursion scanner lets out a ringing chime. Its timer is 0, and its display reads BlingCorp Bank. A red light comes on.

>drop shotgun
You don't think they'd take lightly to littering here.

* * *

I beg your pardon?

>i
You are carrying:
  an incursion scanner
  a notebook
  a map

>s
ZingCorp Bank
A twisting spire of some kind of black stone, this place is often referred to as the wizard's tower because of the affectations of the self-styled Grand Master Zing who runs it. To the north likes Silver Rush, to the south spreads the South District.

>n
Silver Rush
This unassuming place is not to be underestimated - it contains a huge collection of the latest gadgets and you can usually find a good deal. Burly guards lounge threateningly. To the north lies the sparkling marble of the Archives, to the south the spire of ZingCorp Bank.

You can see a counter (on which are a shotgun, a derringer and an orb of transmutation) and an attendant here.

The red light on your scanner blinks out suddenly.
The display of the incursion scanner updates. Its timer now shows 03:00 and its display reads PringCorp Bank.

* * *

>drop orb
You don't think they'd take lightly to littering here.

* * *

>take orb
Your incursion scanner lets out a ringing chime. Its timer is 0, and its display reads PringCorp Bank. A red light comes on.

* * *

>s
A burly guard nonchalantly moves to block your exit. "You gonna pay for that or what?"

Your incursion scanner lets out a ringing chime. Its timer is 0, and its display reads BlingCorp Bank. A red light comes on.

>pay
You exchange 1 for the items. The shopkeeper rubs their hands greedily.

>l
Silver Rush
This unassuming place is not to be underestimated - it contains a huge collection of the latest gadgets and you can usually find a good deal. Burly guards lounge threateningly. To the north lies the sparkling marble of the Archives, to the south the spire of ZingCorp Bank.

You can see a counter (on which are a derringer and an orb of transmutation) and an attendant here.

>get derringer and orb
derringer: Taken.
orb of transmutation: Taken.

>ppay
That's not a verb I recognise.

>pay
You exchange 2 for the items. The shopkeeper rubs their hands greedily.

>s
ZingCorp Bank
A twisting spire of some kind of black stone, this place is often referred to as the wizard's tower because of the affectations of the self-styled Grand Master Zing who runs it. To the north likes Silver Rush, to the south spreads the South District.

The red light on your scanner blinks out suddenly.
The display of the incursion scanner updates. Its timer now shows 03:00 and its display reads DingCorp Bank.

* * *

>s
Silver Rush
This unassuming place is not to be underestimated - it contains a huge collection of the latest gadgets and you can usually find a good deal. Burly guards lounge threateningly. To the north lies the sparkling marble of the Archives, to the south the spire of ZingCorp Bank.

You can see a counter (on which are a derringer, a shotgun and a magnifying glass) and an attendant here.

>get derringer
Taken.

>s
A burly guard nonchalantly moves to block your exit. "You gonna pay for that or what?"

>dro derringer
That's not a verb I recognise.

>drop derringer
You don't think they'd take lightly to littering here.

Your incursion scanner lets out a ringing chime. Its timer is 0, and its display reads BlingCorp Bank. A red light comes on.

>buy
You buy the items.

>s
ZingCorp Bank
A twisting spire of some kind of black stone, this place is often referred to as the wizard's tower because of the affectations of the self-styled Grand Master Zing who runs it. To the north likes Silver Rush, to the south spreads the South District.

>n
Silver Rush
This unassuming place is not to be underestimated - it contains a huge collection of the latest gadgets and you can usually find a good deal. Burly guards lounge threateningly. To the north lies the sparkling marble of the Archives, to the south the spire of ZingCorp Bank.

You can see a counter (on which are a shotgun and an orb of transmutation) and an attendant here.

>i
You are carrying:
  a derringer
  an incursion scanner
  a notebook
  a map

>get shotgun and orb
shotgun: Taken.
orb of transmutation: Taken.

The red light on your scanner blinks out suddenly.
The display of the incursion scanner updates. Its timer now shows 03:00 and its display reads ZingCorp Bank.

>s
A burly guard nonchalantly moves to block your exit. "You gonna pay for that or what?"

>pay
You buy the items.

* * *

>s
Silver Rush
This unassuming place is not to be underestimated - it contains a huge collection of the latest gadgets and you can usually find a good deal. Burly guards lounge threateningly. To the north lies the sparkling marble of the Archives, to the south the spire of ZingCorp Bank.

You can see a counter (on which are a derringer, a shotgun and a magnifying glass) and an attendant here.

>pick up shotgun
Taken.

>s
A burly guard nonchalantly moves to block your exit. "You gonna pay for that or what?"

>i
You are carrying:
  a shotgun
  an incursion scanner
  a notebook
  a map

Your incursion scanner lets out a ringing chime. Its timer is 0, and its display reads BlingCorp Bank. A red light comes on.

>pay
You exchange $1 for the items. The shopkeeper rubs their hands greedily.

>x shopkeeper
You see nothing special about the attendant.

>l
Silver Rush
This unassuming place is not to be underestimated - it contains a huge collection of the latest gadgets and you can usually find a good deal. Burly guards lounge threateningly. To the north lies the sparkling marble of the Archives, to the south the spire of ZingCorp Bank.

You can see a counter (on which are a derringer and an orb of transmutation) and an attendant here.

>x guard
The guards look large, and burly, and bored - a dangerous combination.

>s
ZingCorp Bank
A twisting spire of some kind of black stone, this place is often referred to as the wizard's tower because of the affectations of the self-styled Grand Master Zing who runs it. To the north likes Silver Rush, to the south spreads the South District.

The red light on your scanner blinks out suddenly.
The display of the incursion scanner updates. Its timer now shows 03:00 and its display reads BlingCorp Bank.

* * *

>n,e,e,n
Silver Rush
This unassuming place is not to be underestimated - it contains a huge collection of the latest gadgets and you can usually find a good deal. Burly guards lounge threateningly. To the north lies the sparkling marble of the Archives, to the south the spire of ZingCorp Bank.

You can see a counter (on which are a derringer and an orb of transmutation) and an attendant here.

You can't go that way.

You can't go that way.

Your incursion scanner lets out a ringing chime. Its timer is 0, and its display reads BlingCorp Bank. A red light comes on.

Archives
A marble monument to knowledge. DingCorp Bank is to the north, the Hospital to the west, Silver Rush to the south and the Job Centre to the east.

You can see a research device here.

>e,e,n
Job Centre
A squat block, this place is the place where protifable business actions are transacted - for a fee, of course. The the west lies the Archives, to the north the Prospector's Guild, to the south the Training complex, and to the east a minor bank.

Minor Bank 2
An unassuming brick co-operative. To the west is the Job Centre.

BlingCorp Bank
This baroque structure is bedecked with gold leaf and statues of various important persons in attitudes of important business, straddling the line between gaudy and magnificent. To the south is a much humbler minor bank, while to the east the Eastern District sprawls over the hills.

You can see a Commander Gark here.

>fight commander
You can't see any such thing.

>fight commander gark
You fight the Commander Gark!
The Commander Gark shrugs off the attack!

The Commander Gark attacks!
You are wounded!

The red light on your scanner blinks out suddenly.
In front of your eyes, the monster seems to fold up and twist into a hole in space that does not seem to exist in normal 3d geometry. Suddenly, it's gone.
The display of the incursion scanner updates. Its timer now shows 03:00 and its display reads Minor Bank 4.

>i
You are carrying:
  a shotgun
  an incursion scanner
  a notebook
  a map

>equip shotgun
That's not a verb I recognise.

>drop shotgun
Dropped.

>l
BlingCorp Bank
This baroque structure is bedecked with gold leaf and statues of various important persons in attitudes of important business, straddling the line between gaudy and magnificent. To the south is a much humbler minor bank, while to the east the Eastern District sprawls over the hills.

You can see a shotgun here.

>get shotgun
Taken.

Your incursion scanner lets out a ringing chime. Its timer is 0, and its display reads Minor Bank 4. A red light comes on.

* * *

>s
Silver Rush
This unassuming place is not to be underestimated - it contains a huge collection of the latest gadgets and you can usually find a good deal. Burly guards lounge threateningly. To the north lies the sparkling marble of the Archives, to the south the spire of ZingCorp Bank.

You can see a counter (on which are a derringer, a shotgun and a magnifying glass) and an attendant here.

>get all
derringer: Taken.
shotgun: Taken.
magnifying glass: Taken.

>n
A burly guard nonchalantly moves to block your exit. "You gonna pay for that or what?"

>pay
You exchange $3 for the items. The shopkeeper rubs their hands greedily.

Your incursion scanner lets out a ringing chime. Its timer is 0, and its display reads BlingCorp Bank. A red light comes on.

>s
ZingCorp Bank
A twisting spire of some kind of black stone, this place is often referred to as the wizard's tower because of the affectations of the self-styled Grand Master Zing who runs it. To the north likes Silver Rush, to the south spreads the South District.

>i
You are carrying:
  a magnifying glass
  a shotgun
  a derringer
  an incursion scanner
  a notebook
  a map

>x magnifying glass
You see nothing special about the magnifying glass.

>x shotgun
You see nothing special about the shotgun.

* * *

>s
Silver Rush
This unassuming place is not to be underestimated - it contains a huge collection of the latest gadgets and you can usually find a good deal. Burly guards lounge threateningly. To the north lies the sparkling marble of the Archives, to the south the spire of ZingCorp Bank.

You can see a counter (on which are a derringer, a shotgun and a magnifying glass) and an attendant here.

>get shotgun
Taken.

>ay
That's not a verb I recognise.

>ppay
That's not a verb I recognise.

>pay
You exchange $18 for the items. The shopkeeper rubs their hands greedily.

>get derringer and magnifying
derringer: Taken.
magnifying glass: Taken.

Your incursion scanner lets out a ringing chime. Its timer is 0, and its display reads BlingCorp Bank. A red light comes on.

>pay
You exchange $16 for the items. The shopkeeper rubs their hands greedily.

>s
ZingCorp Bank
A twisting spire of some kind of black stone, this place is often referred to as the wizard's tower because of the affectations of the self-styled Grand Master Zing who runs it. To the north likes Silver Rush, to the south spreads the South District.

>n#
That's not a verb I recognise.

>n
Silver Rush
This unassuming place is not to be underestimated - it contains a huge collection of the latest gadgets and you can usually find a good deal. Burly guards lounge threateningly. To the north lies the sparkling marble of the Archives, to the south the spire of ZingCorp Bank.

You can see a counter and an attendant here.

>ask attendant about sex
There is no reply.

>attack burly
Violence isn't the answer to this one.

The red light on your scanner blinks out suddenly.
The display of the incursion scanner updates. Its timer now shows 03:00 and its display reads DingCorp Bank.

>sa
That's not a verb I recognise.

>e
You can't go that way.

>map
That's not a verb I recognise.

* * *

>n,w
Archives
A marble monument to knowledge. DingCorp Bank is to the north, the Hospital to the west, Silver Rush to the south and the Job Centre to the east.

You can see a research device here.

Hospital
St. Clemens Hospital is a relatively modern construction. To the north lies PringCorp Bank, while a minor bank is to the south. The Archives lie east.

Your incursion scanner lets out a ringing chime. Its timer is 0, and its display reads DingCorp Bank. A red light comes on.

* * *

>s
Silver Rush
This unassuming place is not to be underestimated - it contains a huge collection of the latest gadgets and you can usually find a good deal. Burly guards lounge threateningly. To the north lies the sparkling marble of the Archives, to the south the spire of ZingCorp Bank.

You can see a counter (on which are a derringer, a shotgun and a magnifying glass) and an attendant here.

>restart
Are you sure you want to restart?

>yes
This is the introduction text. Type "help" to see the game rules and instructions.

Gates
An Interactive Fiction by S R Williams
Release 1 / Serial number 191006 / Inform 7 build 6M62 (I6/v6.33 lib 6/12N) SD

Archives
A marble monument to knowledge. DingCorp Bank is to the north, the Hospital to the west, Silver Rush to the south and the Job Centre to the east.

You can see a research device here.

* * *

>l
BlingCorp Bank
This baroque structure is bedecked with gold leaf and statues of various important persons in attitudes of important business, straddling the line between gaudy and magnificent. To the south is a much humbler minor bank, while to the east the Eastern District sprawls over the hills.

You can see a Gark here.

>l
BlingCorp Bank
This baroque structure is bedecked with gold leaf and statues of various important persons in attitudes of important business, straddling the line between gaudy and magnificent. To the south is a much humbler minor bank, while to the east the Eastern District sprawls over the hills.

You can see a Gark here.

>fight gark
You fight the group of 5 Garks!
You fail to harm the group of 5 Garks.

The group of 5 Garks attacks!
You are wounded!

>l
BlingCorp Bank
This baroque structure is bedecked with gold leaf and statues of various important persons in attitudes of important business, straddling the line between gaudy and magnificent. To the south is a much humbler minor bank, while to the east the Eastern District sprawls over the hills.

You can see a Gark here.

>fight gark
You fight the group of 5 Garks!
You hit!

The group of 5 Garks attacks!
You shrug off the blow.

>fight gark
You fight the group of 5 Garks!
You fail to harm the group of 5 Garks.

The group of 5 Garks attacks!
You shrug off the blow.

>fight gark
You fight the group of 5 Garks!
You hit!
One of the group of 5 Garks falls, leaving 4!

The group of 4 Garks attacks!
You shrug off the blow.

>fight gark
You fight the group of 4 Garks!
You fail to harm the group of 4 Garks.

The group of 4 Garks attacks!
You shrug off the blow.

>fight gark
You fight the group of 4 Garks!
You fail to harm the group of 4 Garks.

The group of 4 Garks attacks!
You shrug off the blow.

>fight gark
You fight the group of 4 Garks!
You hit!

The group of 4 Garks attacks!
You are wounded!

>fight gark
You fight the group of 4 Garks!
You hit!
One of the group of 4 Garks falls, leaving 3!

The group of 3 Garks attacks!
You are wounded!

>fight gark
You fight the group of 3 Garks!
You hit!

The group of 3 Garks attacks!
You shrug off the blow.

>fight gark
You fight the group of 3 Garks!
You fail to harm the group of 3 Garks.

The group of 3 Garks attacks!
You are wounded!

>fight gark
You fight the group of 3 Garks!
You fail to harm the group of 3 Garks.

The group of 3 Garks attacks!
You are wounded!

>fight gark
You fight the group of 3 Garks!
You fail to harm the group of 3 Garks.

The group of 3 Garks attacks!
You shrug off the blow.

>fight gark
You fight the group of 3 Garks!
You hit!
One of the group of 3 Garks falls, leaving 2!

The group of 2 Garks attacks!
You are wounded!

Clucking wildly, the monsters retreat in disarray. With an eye-wrenching twist in space, they fold up into nothing and vanish.
The red light on your scanner blinks out suddenly.
The display of the incursion scanner updates. Its timer now shows 03:00 and its display reads Minor Bank 1.

* * *

This is the introduction text. Type "help" to see the game rules and instructions.

Gates
An Interactive Fiction by S R Williams
Release 1 / Serial number 191010 / Inform 7 build 6M62 (I6/v6.33 lib 6/12N) SD

Archives
A marble monument to knowledge. DingCorp Bank is to the north, the Hospital to the west, Silver Rush to the south and the Job Centre to the east.

You can see a research device here.

>pus egg-timer
That's not a verb I recognise.

>push egg-timer
It begins to mark time.

>z
Time passes.

>z
Time passes.

Cluck! Cluck! Cluck! says the egg-timer.

* * *

This is the introduction text. Type "help" to see the game rules and instructions.

Gates
An Interactive Fiction by S R Williams
Release 1 / Serial number 191010 / Inform 7 build 6M62 (I6/v6.33 lib 6/12N) SD

Archives
A marble monument to knowledge. DingCorp Bank is to the north, the Hospital to the west, Silver Rush to the south and the Job Centre to the east.

You can see a research device here.

>press egg-timer
It begins to mark time.

>z
Time passes.

>z
Time passes.

Cluck! Cluck! Cluck! says the egg-timer.

Your incursion scanner lets out a ringing chime. Its timer is 0, and its display reads BlingCorp Bank. A red light comes on.

>x ma
You can't see any such thing.

* * *

>attack monsterOne
You fight the monsterOne!

monsterOne attacks!

The red light on your scanner blinks out suddenly.
The display of the incursion scanner updates. Its timer is now 0 and its display reads BlingCorp Bank.

* * *

This is the introduction text. Type "help" to see the game rules and instructions.

Gates
An Interactive Fiction by S R Williams
Release 1 / Serial number 191010 / Inform 7 build 6M62 (I6/v6.33 lib 6/12N) SD

Archives
A marble monument to knowledge. DingCorp Bank is to the north, the Hospital to the west, Silver Rush to the south and the Job Centre to the east.

You can see a research device here.

>press incursion
It begins to mark time.

>z
Time passes.

* * *

>z
Time passes.

Your incursion scanner lets out a ringing chime. Its timer is 0, and its display reads BlingCorp Bank. A red light comes on.

>s, s, e
Silver Rush
This unassuming place is not to be underestimated - it contains a huge collection of the latest gadgets and you can usually find a good deal. Burly guards lounge threateningly. To the north lies the sparkling marble of the Archives, to the south the spire of ZingCorp Bank.

ZingCorp Bank
A twisting spire of some kind of black stone, this place is often referred to as the wizard's tower because of the affectations of the self-styled Grand Master Zing who runs it. To the north likes Silver Rush, to the south spreads the South District.

You can't go that way.

* * *

>n, n, e, e, n
Silver Rush
This unassuming place is not to be underestimated - it contains a huge collection of the latest gadgets and you can usually find a good deal. Burly guards lounge threateningly. To the north lies the sparkling marble of the Archives, to the south the spire of ZingCorp Bank.

The red light on your scanner blinks out suddenly.
The display of the incursion scanner updates. Its timer is now 0 and its display reads Minor Bank 1.

Archives
A marble monument to knowledge. DingCorp Bank is to the north, the Hospital to the west, Silver Rush to the south and the Job Centre to the east.

You can see a research device here.

Job Centre
A squat block, this place is the place where protifable business actions are transacted - for a fee, of course. The the west lies the Archives, to the north the Prospector's Guild, to the south the Training complex, and to the east a minor bank.

Minor Bank 2
An unassuming brick co-operative. To the west is the Job Centre.

BlingCorp Bank
This baroque structure is bedecked with gold leaf and statues of various important persons in attitudes of important business, straddling the line between gaudy and magnificent. To the south is a much humbler minor bank, while to the east the Eastern District sprawls over the hills.

You can see a monsterOne here.

monsterOne attacks!

>fight monsterOne
You fight the monsterOne!

monsterOne attacks!

* * *

>fight monsterOne
You fight the monsterOne!
the monsterOne has been defeated!

>l
BlingCorp Bank
This baroque structure is bedecked with gold leaf and statues of various important persons in attitudes of important business, straddling the line between gaudy and magnificent. To the south is a much humbler minor bank, while to the east the Eastern District sprawls over the hills.

* * *

>w
Job Centre
A squat block, this place is the place where protifable business actions are transacted - for a fee, of course. The the west lies the Archives, to the north the Prospector's Guild, to the south the Training complex, and to the east a minor bank.

>e
Minor Bank 2
An unassuming brick co-operative. To the west is the Job Centre.

* * *

>e
You can't go that way.

>s
You can't go that way.

* * *

>l
Minor Bank 2
An unassuming brick co-operative. To the west is the Job Centre.

>w,w,n,n
Job Centre
A squat block, this place is the place where protifable business actions are transacted - for a fee, of course. The the west lies the Archives, to the north the Prospector's Guild, to the south the Training complex, and to the east a minor bank.

Archives
A marble monument to knowledge. DingCorp Bank is to the north, the Hospital to the west, Silver Rush to the south and the Job Centre to the east.

You can see a research device here.

DingCorp Bank
An imposing corporate edifice. The Northern district sprawls to the north of here, while the Archives lie to the south.

Northern District
A vast maze of blocks stretching for miles, the Northern District is clean and green and houses the more affluent elements of the city. To the south is the impressive facde of DingCorp Bank.

You can see a cab (in which is a driver) here.

>enter cab
You climb into the cab. The driver says, "Where to?"

* * *

>x Bob
You see nothing special about Bob Jones.

>fight Bob
Violence isn't the answer to this one.

>confront Bob
You persuade Bob!
"OK, I guess... I know the code fragment A1 is at position 10".

* * *

This is the introduction text. Type "help" to see the game rules and instructions.

Gates
An Interactive Fiction by S R Williams
Release 1 / Serial number 191010 / Inform 7 build 6M62 (I6/v6.33 lib 6/12N) SD

Archives
A marble monument to knowledge. DingCorp Bank is to the north, the Hospital to the west, Silver Rush to the south and the Job Centre to the east.

You can see a research device here.

>z
Time passes.

I beg your pardon?

>z
Time passes.

>z
Time passes.

DingCorp Bank has gained 3 crystals.
PringCorp Bank has gained 4 crystals.
Minor Bank 1 has gained 3 crystals.
ZingCorp Bank has gained 2 crystals.
Minor Bank 2 has gained 1 crystals.
Minor Bank 3 has gained 2 crystals.
BlingCorp Bank has gained 3 crystals.
Minor Bank 4 has gained 3 crystals.

>z
Time passes.

* * *

>z
Time passes.

The red light on your scanner blinks out suddenly.
The display of the incursion scanner updates. Its timer now shows 03:00 and its display reads Minor Bank 1.

>z
Time passes.

* * *

>z
Time passes.

The red light on your scanner blinks out suddenly.
The display of the incursion scanner updates. Its timer now shows 03:00 and its display reads Minor Bank 1.

>l
Archives
A marble monument to knowledge. DingCorp Bank is to the north, the Hospital to the west, Silver Rush to the south and the Job Centre to the east.

You can see a research device here.

* * *

>e,n,e
Job Centre
A squat block, this place is the place where protifable business actions are transacted - for a fee, of course. The the west lies the Archives, to the north the Prospector's Guild, to the south the Training complex, and to the east a minor bank.

Prospector's Guild
A somewhat ramshackle affair that belies the incredible wealth that the guild controls. In some sense, all of the city revolves around this place. To the south is the Job Cenre, while to the east is a minor bank.

Your incursion scanner lets out a ringing chime. Its timer is 0, and its display reads Minor Bank 1. A red light comes on.

Minor Bank 3
A neat whitewashed building, likely run by a successful dentist or similar. To the west lies the Prospector's Guild, while to the north glitters the BlingCorp Bank.

>x scanner
A bulbous metal device, with apparently random wires sticking out of it and connecting to other parts. A copper billboard display, hundreds of tiny panels bearing letters and numbers, show the messages. A faint crystal luminesence glimmers in the gaps.

>use scanner
The display reads Minor Bank 1.

* * *

>w,s,e
Prospector's Guild
A somewhat ramshackle affair that belies the incredible wealth that the guild controls. In some sense, all of the city revolves around this place. To the south is the Job Cenre, while to the east is a minor bank.

The red light on your scanner blinks out suddenly.
The display of the incursion scanner updates. Its timer now shows 03:00 and its display reads Minor Bank 1.

Job Centre
A squat block, this place is the place where protifable business actions are transacted - for a fee, of course. The the west lies the Archives, to the north the Prospector's Guild, to the south the Training complex, and to the east a minor bank.

Minor Bank 2
An unassuming brick co-operative. To the west is the Job Centre.

>w,n,w,w,s
Job Centre
A squat block, this place is the place where protifable business actions are transacted - for a fee, of course. The the west lies the Archives, to the north the Prospector's Guild, to the south the Training complex, and to the east a minor bank.

Prospector's Guild
A somewhat ramshackle affair that belies the incredible wealth that the guild controls. In some sense, all of the city revolves around this place. To the south is the Job Cenre, while to the east is a minor bank.

Your incursion scanner lets out a ringing chime. Its timer is 0, and its display reads Minor Bank 1. A red light comes on.

You can't go that way.

You can't go that way.

Job Centre
A squat block, this place is the place where protifable business actions are transacted - for a fee, of course. The the west lies the Archives, to the north the Prospector's Guild, to the south the Training complex, and to the east a minor bank.

>w
Archives
A marble monument to knowledge. DingCorp Bank is to the north, the Hospital to the west, Silver Rush to the south and the Job Centre to the east.

You can see a research device here.

>w,s
Hospital
St. Clemens Hospital is a relatively modern construction. To the north lies PringCorp Bank, while a minor bank is to the south. The Archives lie east.

The red light on your scanner blinks out suddenly.
The display of the incursion scanner updates. Its timer now shows 03:00 and its display reads ZingCorp Bank.

Minor Bank 1
A drab and beaurocratic affair, with a sign that reads "Clemens and Co.". To the north lies the Hospital.

>n,e,s,s
Hospital
St. Clemens Hospital is a relatively modern construction. To the north lies PringCorp Bank, while a minor bank is to the south. The Archives lie east.

Archives
A marble monument to knowledge. DingCorp Bank is to the north, the Hospital to the west, Silver Rush to the south and the Job Centre to the east.

You can see a research device here.

Silver Rush
This unassuming place is not to be underestimated - it contains a huge collection of the latest gadgets and you can usually find a good deal. Burly guards lounge threateningly. To the north lies the sparkling marble of the Archives, to the south the spire of ZingCorp Bank.

Your incursion scanner lets out a ringing chime. Its timer is 0, and its display reads ZingCorp Bank. A red light comes on.

ZingCorp Bank
A twisting spire of some kind of black stone, this place is often referred to as the wizard's tower because of the affectations of the self-styled Grand Master Zing who runs it. To the north likes Silver Rush, to the south spreads the South District.

You can see a monsterOne here.

monsterOne attacks!

>fight monsterOne
You fight the monsterOne!

monsterOne attacks!

>fight monsterOne
You fight the monsterOne!

monsterOne attacks!

The red light on your scanner blinks out suddenly.
The display of the incursion scanner updates. Its timer now shows 03:00 and its display reads Minor Bank 2.

>l
ZingCorp Bank
A twisting spire of some kind of black stone, this place is often referred to as the wizard's tower because of the affectations of the self-styled Grand Master Zing who runs it. To the north likes Silver Rush, to the south spreads the South District.

You can see a monsterOne here.

monsterOne attacks!

>fight monsterOne
You fight the monsterOne!
the monsterOne has been defeated!

* * *

>z
Time passes.

>z
Time passes.

Your incursion scanner lets out a ringing chime. Its timer is 0, and its display reads Minor Bank 2. A red light comes on.

The red light on your scanner blinks out suddenly.
The display of the incursion scanner updates. Its timer now shows 03:00 and its display reads DingCorp Bank.

>n
DingCorp Bank
An imposing corporate edifice. The Northern district sprawls to the north of here, while the Archives lie to the south.

>z
Time passes.

>z
Time passes.

Your incursion scanner lets out a ringing chime. Its timer is 0, and its display reads DingCorp Bank. A red light comes on.

With a strange wrenching motion, things appear to unfold from thin air!
They drop to the ground, gargling, and rush towards the vault.

The monsters shove past you into the vault. Hooting triumphantly, they stuff their sacks full of crystals and, with an eye-wrenching twist in space, fold up into nothing and vanish.
The red light on your scanner blinks out suddenly.
The display of the incursion scanner updates. Its timer now shows 03:00 and its display reads ZingCorp Bank.

* * *

This is the introduction text. Type "help" to see the game rules and instructions.

Gates
An Interactive Fiction by S R Williams
Release 1 / Serial number 191010 / Inform 7 build 6M62 (I6/v6.33 lib 6/12N) SD

Archives
A marble monument to knowledge. DingCorp Bank is to the north, the Hospital to the west, Silver Rush to the south and the Job Centre to the east.

You can see a research device here.

>x ma
You can't see any such thing.

* * *

>e, e, n
Job Centre
A squat block, this place is the place where protifable business actions are transacted - for a fee, of course. The the west lies the Archives, to the north the Prospector's Guild, to the south the Training complex, and to the east a minor bank.

Minor Bank 2
An unassuming brick co-operative. To the west is the Job Centre.

BlingCorp Bank
This baroque structure is bedecked with gold leaf and statues of various important persons in attitudes of important business, straddling the line between gaudy and magnificent. To the south is a much humbler minor bank, while to the east the Eastern District sprawls over the hills.

Your incursion scanner lets out a ringing chime. Its timer is 0, and its display reads BlingCorp Bank. A red light comes on.

>fight commander
You can't see any such thing.

>l
BlingCorp Bank
This baroque structure is bedecked with gold leaf and statues of various important persons in attitudes of important business, straddling the line between gaudy and magnificent. To the south is a much humbler minor bank, while to the east the Eastern District sprawls over the hills.

You can see a Gark here.

Gark attacks!

>fight gark
You fight the Gark!
the Gark has been defeated!

* * *

>l
BlingCorp Bank
This baroque structure is bedecked with gold leaf and statues of various important persons in attitudes of important business, straddling the line between gaudy and magnificent. To the south is a much humbler minor bank, while to the east the Eastern District sprawls over the hills.

You can see a Commander Gark here.

>fight commander gark
You fight the Commander Gark!

The Commander Gark attacks!
You shrug off the blow.

>fight commander gark
You fight the Commander Gark!

The Commander Gark attacks!
You shrug off the blow.

>fight commander gark
You fight the Commander Gark!
The Commander Gark has been defeated!

The red light on your scanner blinks out suddenly.
The display of the incursion scanner updates. Its timer now shows 03:00 and its display reads Minor Bank 3.

* * *

>n,n
DingCorp Bank
An imposing corporate edifice. The Northern district sprawls to the north of here, while the Archives lie to the south.

Northern District
A vast maze of blocks stretching for miles, the Northern District is clean and green and houses the more affluent elements of the city. To the south is the impressive facde of DingCorp Bank.

You can see a cab (in which is a driver) here.

* * *

>enter cab
You climb into the cab. The driver says, "Where to?"

>mine
If you want to mine, better go to a mine eh?

I beg your pardon?

>go to mine
"Sure!" The cab drives off. After a time it arrives at the mine on the outskirts of the city. You pay the driver and get out.

Crystal Mine
You can see a cab (in which is a driver) here.

* * *

This is the introduction text. Type "help" to see the game rules and instructions.

Gates
An Interactive Fiction by S R Williams
Release 1 / Serial number 191010 / Inform 7 build 6M62 (I6/v6.33 lib 6/12N) SD

Archives
A marble monument to knowledge. DingCorp Bank is to the north, the Hospital to the west, Silver Rush to the south and the Job Centre to the east.

You can see a research device here.

>e,e,nb
Job Centre
A squat block, this place is the place where protifable business actions are transacted - for a fee, of course. The the west lies the Archives, to the north the Prospector's Guild, to the south the Training complex, and to the east a minor bank.

Minor Bank 2
An unassuming brick co-operative. To the west is the Job Centre.

That's not a verb I recognise.

>n,
BlingCorp Bank
This baroque structure is bedecked with gold leaf and statues of various important persons in attitudes of important business, straddling the line between gaudy and magnificent. To the south is a much humbler minor bank, while to the east the Eastern District sprawls over the hills.

>z
Time passes.

Your incursion scanner lets out a ringing chime. Its timer is 0, and its display reads BlingCorp Bank. A red light comes on.

>l
BlingCorp Bank
This baroque structure is bedecked with gold leaf and statues of various important persons in attitudes of important business, straddling the line between gaudy and magnificent. To the south is a much humbler minor bank, while to the east the Eastern District sprawls over the hills.

You can see a Gark here.

>x gark
You see nothing special about the Gark.

>fight gark
You fight the Gark!
the Gark has been defeated!

The red light on your scanner blinks out suddenly.
The display of the incursion scanner updates. Its timer now shows 03:00 and its display reads DingCorp Bank.

* * *

>s,w,wn
Minor Bank 2
An unassuming brick co-operative. To the west is the Job Centre.

Job Centre
A squat block, this place is the place where protifable business actions are transacted - for a fee, of course. The the west lies the Archives, to the north the Prospector's Guild, to the south the Training complex, and to the east a minor bank.

Your incursion scanner lets out a ringing chime. Its timer is 0, and its display reads DingCorp Bank. A red light comes on.

That's not a verb I recognise.

>w,n
Archives
A marble monument to knowledge. DingCorp Bank is to the north, the Hospital to the west, Silver Rush to the south and the Job Centre to the east.

You can see a research device here.

DingCorp Bank
An imposing corporate edifice. The Northern district sprawls to the north of here, while the Archives lie to the south.

>l
DingCorp Bank
An imposing corporate edifice. The Northern district sprawls to the north of here, while the Archives lie to the south.

* * *

This is the introduction text. Type "help" to see the game rules and instructions.

Gates
An Interactive Fiction by S R Williams
Release 1 / Serial number 191010 / Inform 7 build 6M62 (I6/v6.33 lib 6/12N) SD

Archives
A marble monument to knowledge. DingCorp Bank is to the north, the Hospital to the west, Silver Rush to the south and the Job Centre to the east.

You can see a research device here.

>e,e,n
Job Centre
A squat block, this place is the place where protifable business actions are transacted - for a fee, of course. The the west lies the Archives, to the north the Prospector's Guild, to the south the Training complex, and to the east a minor bank.

Minor Bank 2
An unassuming brick co-operative. To the west is the Job Centre.

BlingCorp Bank
This baroque structure is bedecked with gold leaf and statues of various important persons in attitudes of important business, straddling the line between gaudy and magnificent. To the south is a much humbler minor bank, while to the east the Eastern District sprawls over the hills.

>z
Time passes.

Your incursion scanner lets out a ringing chime. Its timer is 0, and its display reads BlingCorp Bank. A red light comes on.

With a strange wrenching motion, things appear to unfold from thin air!
They drop to the ground, gargling, and rush towards the vault.

>l
BlingCorp Bank
This baroque structure is bedecked with gold leaf and statues of various important persons in attitudes of important business, straddling the line between gaudy and magnificent. To the south is a much humbler minor bank, while to the east the Eastern District sprawls over the hills.

You can see a Gark here.

>fight gark
You fight the Gark!
The Gark shrugs off the attack!

The Gark attacks!
You are wounded!

>fight gark
You fight the Gark!

The Gark attacks!
You shrug off the blow.

>fight gark
You fight the Gark!

The Gark attacks!
You shrug off the blow.

>fight gark
You fight the Gark!
The Gark has been defeated!

The red light on your scanner blinks out suddenly.
The display of the incursion scanner updates. Its timer now shows 03:00 and its display reads Minor Bank 4.

* * *

>z
Time passes.

Your incursion scanner lets out a ringing chime. Its timer is 0, and its display reads BlingCorp Bank. A red light comes on.

With a strange wrenching motion, things appear to unfold from thin air!
They drop to the ground, gargling, and rush towards the vault.

>fight monster
You can't see any such thing.

>fight gark
You fight the group of 4 Garks!
You fail to harm the group of 4 Garks.

The group of 4 Garks attacks!
You are wounded!

>fight gark
You fight the group of 4 Garks!
You hit!

The group of 4 Garks attacks!
You shrug off the blow.

>fight gark
You fight the group of 4 Garks!
You hit!
One of the group of 4 Garks falls, leaving 3!

The group of 3 Garks attacks!
You are wounded!

>fight gark
You fight the group of 3 Garks!
You hit!

The group of 3 Garks attacks!
You are wounded!

>fight gark
You fight the group of 3 Garks!
You hit!
One of the group of 3 Garks falls, leaving 2!

The group of 2 Garks attacks!
You shrug off the blow.

>fight gark
You fight the group of 2 Garks!
You fail to harm the group of 2 Garks.

The group of 2 Garks attacks!
You are wounded!

>fight gark
You fight the group of 2 Garks!
You hit!

The group of 2 Garks attacks!
You are wounded!

>fight gark
You fight the group of 2 Garks!
You fail to harm the group of 2 Garks.

The group of 2 Garks attacks!
You are wounded!

>fight gark
You fight the group of 2 Garks!
You hit!
One of the group of 2 Garks falls, leaving 1!

The Gark attacks!
You are wounded!

Clucking wildly, the monsters retreat in disarray. With an eye-wrenching twist in space, they fold up into nothing and vanish.
The red light on your scanner blinks out suddenly.
The display of the incursion scanner updates. Its timer now shows 03:00 and its display reads BlingCorp Bank.

>z
Time passes.

>x ma
You can't see any such thing.

* * *

>s, w, w, w
Minor Bank 2
An unassuming brick co-operative. To the west is the Job Centre.

Your incursion scanner lets out a ringing chime. Its timer is 0, and its display reads BlingCorp Bank. A red light comes on.

The red light on your scanner blinks out suddenly.
The display of the incursion scanner updates. Its timer now shows 03:00 and its display reads Minor Bank 4.

Job Centre
A squat block, this place is the place where protifable business actions are transacted - for a fee, of course. The the west lies the Archives, to the north the Prospector's Guild, to the south the Training complex, and to the east a minor bank.

Archives
A marble monument to knowledge. DingCorp Bank is to the north, the Hospital to the west, Silver Rush to the south and the Job Centre to the east.

You can see a research device here.

Hospital
St. Clemens Hospital is a relatively modern construction. To the north lies PringCorp Bank, while a minor bank is to the south. The Archives lie east.

>use hospital
You can't see any such thing.

>talk to doctor
You can't see any such thing.

>z
Time passes.

Your incursion scanner lets out a ringing chime. Its timer is 0, and its display reads Minor Bank 4. A red light comes on.

The red light on your scanner blinks out suddenly.
The display of the incursion scanner updates. Its timer now shows 03:00 and its display reads Minor Bank 4.

* * *

This is the introduction text. Type "help" to see the game rules and instructions.

Gates
An Interactive Fiction by S R Williams
Release 1 / Serial number 191010 / Inform 7 build 6M62 (I6/v6.33 lib 6/12N) SD

Archives
A marble monument to knowledge. DingCorp Bank is to the north, the Hospital to the west, Silver Rush to the south and the Job Centre to the east.

You can see a research device here.

>e, e
Job Centre
A squat block, this place is the place where protifable business actions are transacted - for a fee, of course. The the west lies the Archives, to the north the Prospector's Guild, to the south the Training complex, and to the east a minor bank.

Minor Bank 2
An unassuming brick co-operative. To the west is the Job Centre.

>l
Minor Bank 2
An unassuming brick co-operative. To the west is the Job Centre.

>x map
Your incursion scanner lets out a ringing chime. Its timer is 0, and its display reads BlingCorp Bank. A red light comes on.

>n
BlingCorp Bank
This baroque structure is bedecked with gold leaf and statues of various important persons in attitudes of important business, straddling the line between gaudy and magnificent. To the south is a much humbler minor bank, while to the east the Eastern District sprawls over the hills.

You can see a group of 1 Garks here.

>fight gark
You fight the group of 1 Garks!
The group of 1 Garks shrugs off the attack!

The group of 1 Garks attacks!
You shrug off the blow.

>fight group of
You can't see any such thing.

>fight gark
You fight the group of 1 Garks!
The group of 1 Garks is wounded!

The group of 1 Garks attacks!
You shrug off the blow.

>fight gark
You fight the group of 1 Garks!
The group of 1 Garks is wounded!
The group of 1 Garks has been defeated!

The red light on your scanner blinks out suddenly.
The display of the incursion scanner updates. Its timer now shows 03:00 and its display reads PringCorp Bank.

>l
BlingCorp Bank
This baroque structure is bedecked with gold leaf and statues of various important persons in attitudes of important business, straddling the line between gaudy and magnificent. To the south is a much humbler minor bank, while to the east the Eastern District sprawls over the hills.

* * *

>s
Minor Bank 2
An unassuming brick co-operative. To the west is the Job Centre.

>x bank
You can't see any such thing.

* * *

This is the introduction text. Type "help" to see the game rules and instructions.

Gates
An Interactive Fiction by S R Williams
Release 1 / Serial number 191010 / Inform 7 build 6M62 (I6/v6.33 lib 6/12N) SD

Archives
A marble monument to knowledge. DingCorp Bank is to the north, the Hospital to the west, Silver Rush to the south and the Job Centre to the east.

You can see a research device here.

>use incursion scanner
The display reads BlingCorp Bank.

>e, e, n
Job Centre
A squat block, this place is the place where protifable business actions are transacted - for a fee, of course. The the west lies the Archives, to the north the Prospector's Guild, to the south the Training complex, and to the east a minor bank.

Minor Bank 2
An unassuming brick co-operative. To the west is the Job Centre.

BlingCorp Bank
This baroque structure is bedecked with gold leaf and statues of various important persons in attitudes of important business, straddling the line between gaudy and magnificent. To the south is a much humbler minor bank, while to the east the Eastern District sprawls over the hills.

Your incursion scanner lets out a ringing chime. Its timer is 0, and its display reads BlingCorp Bank. A red light comes on.

With a strange wrenching motion, things appear to unfold from thin air!
They drop to the ground, gargling, and rush towards the vault.

>fight gark
You can't see any such thing.

>l
BlingCorp Bank
This baroque structure is bedecked with gold leaf and statues of various important persons in attitudes of important business, straddling the line between gaudy and magnificent. To the south is a much humbler minor bank, while to the east the Eastern District sprawls over the hills.

You can see a Commander Gark here.

>fight commander gark
You fight the group of 6 Commander Garks!
You fail to harm the group of 6 Commander Garks.

The group of 6 Commander Garks attacks!
You are wounded!

>w
You can't go that way.

>s
Minor Bank 2
An unassuming brick co-operative. To the west is the Job Centre.

>z
Time passes.

* * *

This is the introduction text. Type "help" to see the game rules and instructions.

Gates
An Interactive Fiction by S R Williams
Release 1 / Serial number 191010 / Inform 7 build 6M62 (I6/v6.33 lib 6/12N) SD

Archives
A marble monument to knowledge. DingCorp Bank is to the north, the Hospital to the west, Silver Rush to the south and the Job Centre to the east.

You can see a research device here.

>mine
If you want to mine, better go to a mine eh?

* * *

This is the introduction text. Type "help" to see the game rules and instructions.

Gates
An Interactive Fiction by S R Williams
Release 1 / Serial number 191010 / Inform 7 build 6M62 (I6/v6.33 lib 6/12N) SD

Archives
A marble monument to knowledge. DingCorp Bank is to the north, the Hospital to the west, Silver Rush to the south and the Job Centre to the east.

You can see a research device here.

>e, n
Job Centre
A squat block, this place is the place where protifable business actions are transacted - for a fee, of course. The the west lies the Archives, to the north the Prospector's Guild, to the south the Training complex, and to the east a minor bank.

Prospector's Guild
A somewhat ramshackle affair that belies the incredible wealth that the guild controls. In some sense, all of the city revolves around this place. To the south is the Job Cenre, while to the east is a minor bank.

On the wall a battered sign exclaims "Exchange crystals for ready cash! Great rates available!"

You can also see a teller here.

* * *

>x teller
She looks at you appraisingly through her monocle.

>ask teller about crystals
There is no reply.

>punch teller
Violence isn't the answer to this one.

>attack teller
Violence isn't the answer to this one.

>sell crystals
You don't have any crystals to sell.

>x mapp
You can't see any such thing.

>x mapp
You can't see any such thing.

* * *

>s,w,n,n
Job Centre
A squat block, this place is the place where protifable business actions are transacted - for a fee, of course. The the west lies the Archives, to the north the Prospector's Guild, to the south the Training complex, and to the east a minor bank.

Archives
A marble monument to knowledge. DingCorp Bank is to the north, the Hospital to the west, Silver Rush to the south and the Job Centre to the east.

You can see a research device here.

DingCorp Bank
An imposing corporate edifice. The Northern district sprawls to the north of here, while the Archives lie to the south.

Northern District
A vast maze of blocks stretching for miles, the Northern District is clean and green and houses the more affluent elements of the city. To the south is the impressive facde of DingCorp Bank.

You can see a cab (in which is a driver) here.

>enter cab
You climb into the cab. The driver says, "Where to?"

* * *

>go to mine
"Sure!" The cab drives off. After a time it arrives at the mine on the outskirts of the city. You pay the driver and get out.

Crystal Mine
A rent in the earth disapears into a darkness ahead of you, leading into an underground labyrinth. Precious crystals are here for the taking.

You can see a cab (in which is a driver) here.

>explore
You enter the opening and descend into the darkness. Outside of the tiny illuminated sphere of your flickering yellow lamp light, it is pitck dark.
After some time, you detect the strange ethereal glow of your quarry ahead! You dig out the cache, taking 3 crystals.

>explore
You enter the opening and descend into the darkness. Outside of the tiny illuminated sphere of your flickering yellow lamp light, it is pitck dark.
After some time, you detect the strange ethereal glow of your quarry ahead! You dig out the cache, taking 5 crystals.

>expplore
That's not a verb I recognise.

>explore
You enter the opening and descend into the darkness. Outside of the tiny illuminated sphere of your flickering yellow lamp light, it is pitck dark.
After some time, you detect the strange ethereal glow of your quarry ahead! You dig out the cache, taking 1 crystals.

>mine
You enter the opening and descend into the darkness. Outside of the tiny illuminated sphere of your flickering yellow lamp light, it is pitck dark.
You wander the caverns, but can find nothing of interest. You return to the daylight.

>enter cab
You climb into the cab. The driver says, "Where to?"

* * *

>go to city
"Sure!" The cab returns to the centre of town. You pay the driver and get out.

Northern District
A vast maze of blocks stretching for miles, the Northern District is clean and green and houses the more affluent elements of the city. To the south is the impressive facde of DingCorp Bank.

You can see a cab (in which is a driver) here.

>x map
The incursion scanner lets out a warning clang. The display updates. Its timer now shows 06:00 and its display reads Minor Bank 4.

>s,s,e,n
DingCorp Bank
An imposing corporate edifice. The Northern district sprawls to the north of here, while the Archives lie to the south.

Archives
A marble monument to knowledge. DingCorp Bank is to the north, the Hospital to the west, Silver Rush to the south and the Job Centre to the east.

You can see a research device here.

Job Centre
A squat block, this place is the place where protifable business actions are transacted - for a fee, of course. The the west lies the Archives, to the north the Prospector's Guild, to the south the Training complex, and to the east a minor bank.

Prospector's Guild
A somewhat ramshackle affair that belies the incredible wealth that the guild controls. In some sense, all of the city revolves around this place. To the south is the Job Cenre, while to the east is a minor bank.

On the wall a battered sign exclaims "Exchange crystals for ready cash! Great rates available!"

You can also see a teller here.

>sell crystals
You show your haul to the teller. After some haggling, she agrees to take the crystals off your hands for $18

>thanks
That's not a verb I recognise.

* * *

This is the introduction text. Type "help" to see the game rules and instructions.

Gates
An Interactive Fiction by S R Williams
Release 1 / Serial number 191010 / Inform 7 build 6M62 (I6/v6.33 lib 6/12N) SD

Archives
A marble monument to knowledge. DingCorp Bank is to the north, the Hospital to the west, Silver Rush to the south and the Job Centre to the east.

You can see a research device here.

>w
Hospital
St. Clemens Hospital is a relatively modern construction. To the north lies PringCorp Bank, while a minor bank is to the south. The Archives lie east.

You can see a doctor here.

>talk to doctor
You talk the doctor. They patch you up.

>talk to doctor
You don't need to see the doctor.